Market_and_Exchange_Names,Report_Date_as_MM_DD_YYYY,CFTC_Contract_Market_Code,Open_Interest_All,Prod_Merc_Positions_Long_ALL,Prod_Merc_Positions_Short_ALL,Swap_Positions_Long_All,Swap__Positions_Short_All,Swap__Positions_Spread_All,M_Money_Positions_Long_ALL,M_Money_Positions_Short_ALL,M_Money_Positions_Spread_ALL,Other_Rept_Positions_Long_ALL,Other_Rept_Positions_Short_ALL,Other_Rept_Positions_Spread_ALL,Tot_Rept_Positions_Long_All,Tot_Rept_Positions_Short_All,NonRept_Positions_Long_All,NonRept_Positions_Short_All,Comm_Net,Comm_Max,Comm_Min,Comm_Index,M_Money_Net,M_Money_Max,M_Money_Min,M_Money_Index,Swap_Net,Swap_Max,Swap_Min,Swap_Index,Other_Net,Other_Max,Other_Min,Other_Index,Price,Price_Min,Price_Max,Price_Index
WHEAT-HRW - CHICAGO BOARD OF TRADE,6/7/2022,001612,180335,27893,89534,39213,10505,2857,45353,9135,24285,9489,11678,10143,159233,158137,21102,22198,-61641,-7150,-102845,43.05763102,28708,51971,18064,31.39174802,36218,65320,-45044,73.63089413,14796,44660,-2250,36.33766787,1149.25,1367.75,362,78.27491921
WHEAT-HRW - CHICAGO BOARD OF TRADE,5/31/2022,001612,180591,27359,91964,38606,10729,2632,48799,9128,21919,9554,12958,10100,158969,159430,21622,21161,-64605,-7150,-102845,39.96029051,27877,51971,18064,28.94092665,39671,65320,-45044,76.75963176,12365,46425,-2250,30.02568053,1165.5,1367.75,362,79.89062888
WHEAT-HRW - CHICAGO BOARD OF TRADE,5/24/2022,001612,177697,25898,93816,39067,11076,1610,51278,7548,20938,9006,14066,7864,155661,156918,22036,20779,-67918,-7150,-102845,36.49824965,27991,51971,18064,29.27714041,43730,65320,-45044,80.43746149,11932,46425,-2250,29.13610683,1237.75,1367.75,362,87.07432264
WHEAT-HRW - CHICAGO BOARD OF TRADE,5/17/2022,001612,174905,25765,95614,39496,10919,1669,51541,5438,19380,8808,15914,5502,152161,154436,22744,20469,-69849,-7150,-102845,34.48038038,28577,51971,18064,31.00539712,46103,65320,-49136,83.21014189,10572,49923,-2250,24.57593008,1367.75,1367.75,362,100
WHEAT-HRW - CHICAGO BOARD OF TRADE,5/10/2022,001612,172577,25423,94054,38993,10735,1164,49439,7491,18011,10168,14537,7246,150444,153238,22133,19339,-68631,-7150,-102845,35.75317415,28258,51971,18064,30.06458843,41948,65320,-57198,80.92361939,7843,49923,-2250,19.34525521,1168.25,1186,362,97.84587379
WHEAT-HRW - CHICAGO BOARD OF TRADE,5/3/2022,001612,171872,24086,93912,39787,10179,1845,49067,9530,15067,12435,14439,8113,150400,153085,21472,18787,-69826,-7150,-102845,34.50441507,29608,51971,18064,34.04606718,39537,65320,-59759,79.38662765,2632,49923,-2250,9.35733042,1081.75,1186,362,87.34830097
WHEAT-HRW - CHICAGO BOARD OF TRADE,4/26/2022,001612,173692,24920,97379,39909,11583,1582,52024,7143,13493,11710,16164,8134,151772,155478,21920,18214,-72459,-6607,-102845,31.5738066,28326,51971,18064,30.26513699,44881,65320,-59759,83.65912743,1783,49923,-2250,7.730051943,1157.75,1186,362,96.57160194
WHEAT-HRW - CHICAGO BOARD OF TRADE,4/19/2022,001612,177370,25393,97206,37936,12753,2546,53832,3867,15531,10261,15934,9805,155304,157642,22066,19728,-71813,-6607,-102845,32.24505912,25183,51971,18064,20.99566461,49965,65320,-59759,87.72375858,5270,49923,-2250,14.41358557,1171.5,1186,362,98.24029126
WHEAT-HRW - CHICAGO BOARD OF TRADE,4/12/2022,001612,175900,25838,94922,38354,14651,1748,53397,3909,15717,9624,15812,9470,154148,156229,21752,19671,-69084,-6607,-102845,35.08073734,23703,51971,18064,16.6307842,49488,65320,-59759,87.3423996,6093,49923,-2250,15.99102984,1162.25,1186,362,97.11771845
WHEAT-HRW - CHICAGO BOARD OF TRADE,4/5/2022,001612,178149,27768,94888,37971,14889,2644,50021,4828,18838,11777,13872,9671,158690,159630,19459,18519,-67120,-6607,-102845,37.12151125,23082,51971,18064,14.79930398,45193,65320,-59759,83.90856978,7061,49923,-2250,17.84639565,1082.75,1186,362,87.46966019
WHEAT-HRW - CHICAGO BOARD OF TRADE,3/29/2022,001612,178444,25683,93877,38285,15777,3508,50189,5226,18325,12621,12558,11709,160320,160980,18124,17464,-68194,-6607,-102845,36.00552796,22508,51971,18064,13.1064382,44963,65320,-59759,83.724686,5704,49923,-2250,15.24543346,1024.5,1186,362,80.40048544
WHEAT-HRW - CHICAGO BOARD OF TRADE,3/22/2022,001612,178217,26305,95627,39468,15976,2780,50357,5029,16121,13401,12719,10827,159259,159079,18958,19138,-69322,-6607,-102845,34.83343378,23492,51971,18064,16.00849382,45328,65320,-59759,84.01650157,2720,49923,-2250,9.526000038,1116.5,1186,362,91.56553398
WHEAT-HRW - CHICAGO BOARD OF TRADE,3/15/2022,001612,178859,28015,98354,39734,14660,3814,48622,4814,16422,13075,12606,9253,158935,159923,19924,18936,-70339,-6607,-102845,33.77667865,25074,51971,18064,20.67419707,43808,65320,-59759,82.8012696,3347,49923,-2250,10.72777107,1157.5,1186,362,96.54126214
WHEAT-HRW - CHICAGO BOARD OF TRADE,3/8/2022,001612,184723,27454,98368,41380,14962,4001,50978,6582,17870,13852,14327,9063,164598,165173,20125,19550,-70914,-6607,-102845,33.17920156,26418,51971,18064,24.63798036,44396,65320,-59759,83.27137249,4018,49923,-2250,12.01387691,1186,1186,362,100
WHEAT-HRW - CHICAGO BOARD OF TRADE,3/1/2022,001612,208293,27710,96261,39868,14562,5416,53250,8443,35922,13069,16260,10353,185588,187217,22705,21076,-68551,-6607,-102845,35.63457262,25306,51971,18064,21.35842156,44807,65320,-59759,83.59996482,22853,49923,-2250,48.11492534,1012,1012,362,100
WHEAT-HRW - CHICAGO BOARD OF TRADE,2/22/2022,001612,213586,32993,97526,39967,13463,5606,50329,9965,34228,13563,16224,12104,188790,189116,24796,24470,-64533,-6607,-102845,39.8096386,26504,51971,18064,24.8916153,40364,65320,-59759,80.04780978,20665,49923,-2250,43.92118529,881.75,881.75,362,100
WHEAT-HRW - CHICAGO BOARD OF TRADE,2/15/2022,001612,221307,34022,95502,39458,12173,6332,47652,11927,35563,14727,16156,18885,196639,196538,24668,24769,-61480,-6607,-102845,42.98198217,27285,51971,18064,27.19497449,35725,65320,-59759,76.33895378,20836,49923,-2250,44.24894102,806,878.75,362,85.92162554
WHEAT-HRW - CHICAGO BOARD OF TRADE,2/8/2022,001612,212689,31685,93690,39419,12285,5911,45388,11350,30886,16103,17348,17645,187037,189115,25652,23574,-62005,-6607,-102845,42.43645961,27134,51971,18064,26.74963872,34038,65320,-59759,74.99020619,14783,49923,-2250,32.64715466,801.25,878.75,362,85.00241896
WHEAT-HRW - CHICAGO BOARD OF TRADE,2/1/2022,001612,218513,34241,96021,37879,12118,7848,47747,10335,35599,15619,18244,15239,194172,195404,24341,23109,-61780,-6607,-102845,42.67025499,25761,51971,18064,22.70032737,37412,65320,-59759,77.68770137,19980,49923,-2250,42.60824564,786.25,878.75,362,82.09966134
WHEAT-HRW - CHICAGO BOARD OF TRADE,1/25/2022,001612,211960,32720,94717,38978,11806,6137,50223,10843,33070,13680,18145,13919,188727,188637,23233,23323,-61997,-6607,-102845,42.44477234,27172,51971,18064,26.86170997,39380,65320,-59759,79.26110698,19390,49923,-2250,41.47739252,834.5,878.75,362,91.43686502
WHEAT-HRW - CHICAGO BOARD OF TRADE,1/18/2022,001612,212141,33474,96131,38006,11214,6331,50991,15627,27695,16649,18446,14854,188000,190298,24141,21843,-62657,-6607,-102845,41.75897255,26792,51971,18064,25.74099743,35364,65320,-59759,76.05033619,11046,49923,-2250,25.48444598,772.75,878.75,362,79.48717949
WHEAT-HRW - CHICAGO BOARD OF TRADE,1/11/2022,001612,215528,32926,97012,36319,13723,5858,58829,16774,28486,15036,18313,13964,191418,194130,24110,21398,-64086,-6607,-102845,40.2741121,22596,51971,18064,13.36597163,42055,65320,-59759,81.39975535,13450,49923,-2250,30.09219328,791.75,878.75,362,83.16400581
WHEAT-HRW - CHICAGO BOARD OF TRADE,1/4/2022,001612,222583,29074,102692,39583,13978,3655,68883,17693,28830,12480,18639,15932,198437,201419,24146,21164,-73618,-6607,-102845,30.36950061,25605,51971,18064,22.24024538,51190,65320,-59759,88.70313962,16350,49923,-2250,35.65062389,804,878.75,362,85.53459119
WHEAT-HRW - CHICAGO BOARD OF TRADE,12/28/2021,001612,220413,26413,106749,41299,14812,2867,74610,16027,27837,11763,17764,12741,197530,198797,22883,21616,-80336,-6607,-102845,23.38889004,26487,51971,18064,24.84147816,58583,65320,-59759,94.61380408,16074,49923,-2250,35.12161463,821.75,878.75,362,88.96952104
WHEAT-HRW - CHICAGO BOARD OF TRADE,12/21/2021,001612,216719,27023,106288,40980,14599,2792,73928,15989,26884,9669,17520,12244,193520,196316,23199,20403,-79265,-6607,-102845,24.50175606,26381,51971,18064,24.52885835,57939,65320,-59759,94.09892948,17215,49923,-2250,37.30856957,841.5,878.75,362,92.79148524
WHEAT-HRW - CHICAGO BOARD OF TRADE,12/14/2021,001612,215046,24654,100735,42220,14910,2317,76920,20023,24070,8529,19592,13761,192471,195408,22575,19638,-76081,-6607,-102845,27.8102205,27310,51971,18064,27.26870558,56897,65320,-59759,93.26585598,15541,49923,-2250,34.10001342,805.25,878.75,362,85.77648766
WHEAT-HRW - CHICAGO BOARD OF TRADE,12/7/2021,001612,221831,25143,106057,42991,14305,2119,80140,20890,24067,9129,19276,14777,198366,201491,23465,20340,-80914,-6607,-102845,22.78829568,28686,51971,18064,31.32686466,59250,65320,-59759,95.14706705,14938,49923,-2250,32.94424319,827.25,878.75,362,90.03386551
WHEAT-HRW - CHICAGO BOARD OF TRADE,11/30/2021,001612,227423,27762,110222,42672,14107,3021,83297,21382,27493,9026,18308,12875,206146,207408,21277,20015,-82460,-6607,-102845,21.18186163,28565,51971,18064,30.97000619,61915,65320,-59759,97.27772048,18467,49923,-2250,39.70827823,819,878.75,362,88.43734881
WHEAT-HRW - CHICAGO BOARD OF TRADE,11/23/2021,001612,239102,29120,111653,43280,15407,3931,85523,20203,30164,9801,22217,14024,215843,217599,23259,21503,-82533,-6607,-102845,21.10600802,27873,51971,18064,28.92912968,65320,65320,-59759,100,20363,49923,-2250,43.34234182,878.75,878.75,362,100
WHEAT-HRW - CHICAGO BOARD OF TRADE,11/16/2021,001612,237136,24309,109686,43788,12771,5332,81202,21730,29434,10765,19747,17190,212020,215890,25116,21246,-85377,-6607,-102845,18.15083439,31017,51971,18064,38.2015513,59472,60239,-59759,99.36082268,18669,49923,-2250,40.09545167,820.75,820.75,362,100
WHEAT-HRW - CHICAGO BOARD OF TRADE,11/9/2021,001612,233489,26740,110998,43522,9467,3592,80238,24176,27886,11014,17782,17302,210294,211203,23195,22286,-84258,-6607,-102845,19.31357676,34055,51971,18064,47.16135311,56062,60239,-59759,96.51910865,16872,49923,-2250,36.65114139,793.5,798.25,362,98.91117479
WHEAT-HRW - CHICAGO BOARD OF TRADE,11/2/2021,001612,235472,25315,111845,42846,8305,6233,81396,25355,31312,12208,16953,13638,212948,213641,22524,21831,-86530,-6607,-102845,16.95276294,34541,51971,18064,48.59468546,56041,60239,-59759,96.50160836,19104,49923,-2250,40.92921626,798.25,798.25,362,100
WHEAT-HRW - CHICAGO BOARD OF TRADE,10/26/2021,001612,236941,29367,109785,42529,9981,4737,81340,29497,30518,12397,17679,13425,214313,215622,22628,21319,-80418,-6607,-102845,23.30368462,32548,51971,18064,42.71684313,51843,60239,-59759,93.00321672,18121,49923,-2250,39.04509996,777.25,777.25,362,100
WHEAT-HRW - CHICAGO BOARD OF TRADE,10/19/2021,001612,235946,35033,110907,42122,9432,3743,75963,29457,30356,13547,17816,13036,213800,214747,22146,21199,-75874,-6607,-102845,28.02531225,32690,51971,18064,43.13563571,46506,60239,-59759,88.55564259,16809,49923,-2250,36.53038928,748.25,748.25,362,100
WHEAT-HRW - CHICAGO BOARD OF TRADE,10/12/2021,001612,234627,33050,110814,42375,9594,3686,76854,29345,29631,14309,17516,13271,213176,213857,21451,20770,-77764,-6607,-102845,26.06143104,32781,51971,18064,43.40401687,47509,60239,-59759,89.39148986,15322,49923,-2250,33.68025607,739.75,741,362,99.6701847
WHEAT-HRW - CHICAGO BOARD OF TRADE,10/5/2021,001612,230413,30425,110733,42629,8855,3102,77468,28251,30545,14458,17983,10762,209389,210231,21024,20182,-80308,-6607,-102845,23.41798458,33774,51971,18064,46.33261568,49217,60239,-59759,90.81484691,16087,49923,-2250,35.14653173,741,741,362,100
WHEAT-HRW - CHICAGO BOARD OF TRADE,9/28/2021,001612,224674,32382,105822,44145,10738,3644,75805,30188,25028,13474,17549,11023,205501,203992,19173,20682,-73440,-6607,-102845,30.55445874,33407,51971,18064,45.25024331,45617,60239,-59759,87.81479691,11554,49923,-2250,26.45812968,705,716.75,362,96.68780832
WHEAT-HRW - CHICAGO BOARD OF TRADE,9/21/2021,001612,225465,29425,101673,48715,8365,3335,69990,31333,29864,11748,18413,12306,205383,205289,20082,20176,-72248,-6607,-102845,31.79305472,40350,51971,18064,65.72684107,38657,60239,-59759,82.01470025,18116,49923,-2250,39.03551645,690.5,716.75,362,92.60042283
WHEAT-HRW - CHICAGO BOARD OF TRADE,9/14/2021,001612,223846,29206,102894,50256,9683,2815,68278,31369,29072,13217,17878,11460,204304,205171,19542,18675,-73688,-6607,-102845,30.29676427,40573,51971,18064,66.38452237,36909,60239,-59759,80.5580093,15855,49923,-2250,34.70185728,686.5,716.75,362,91.47286822
WHEAT-HRW - CHICAGO BOARD OF TRADE,9/7/2021,001612,237015,31540,109856,51129,10213,3647,72827,32419,31992,13695,18504,12050,216880,218681,20135,18334,-78316,-6607,-102845,25.48785303,40916,51971,18064,67.3961129,40408,60239,-59759,83.47389123,18297,49923,-2250,39.38243919,709.75,716.75,362,98.02677942
WHEAT-HRW - CHICAGO BOARD OF TRADE,8/31/2021,001612,231629,28440,111081,49485,10051,3504,78635,31701,28706,12462,17341,10485,211717,212869,19912,18760,-82641,-6607,-102845,20.99378624,39434,51971,18064,63.025334,46934,60239,-59759,88.91231521,16244,49923,-2250,35.44745366,705.25,716.75,362,96.75828048
WHEAT-HRW - CHICAGO BOARD OF TRADE,8/24/2021,001612,232626,33553,119380,48954,7350,2973,76864,30138,26079,10589,15404,11181,210193,212505,22433,20121,-85827,-6607,-107645,21.59385578,41604,51971,18064,69.42519244,46726,60239,-59759,88.73897898,15490,49923,-2250,34.00226171,704.25,716.75,362,96.47639183
WHEAT-HRW - CHICAGO BOARD OF TRADE,8/17/2021,001612,229763,37673,123721,49351,6839,2218,73203,27630,23911,9274,13214,12152,207782,209685,21981,20078,-86048,-6607,-112533,25.00330419,42512,51971,18064,72.10310555,45573,63364,-59759,85.55022214,14637,49923,-2250,32.36731643,716.75,716.75,362,100
WHEAT-HRW - CHICAGO BOARD OF TRADE,8/10/2021,001612,230837,34930,120348,51061,5566,1920,68740,25026,30729,8812,11807,14123,210315,209519,20522,21318,-85418,-6607,-112533,25.59805902,45495,51971,18064,80.90069897,43714,63364,-59759,84.04034989,21917,49923,-2250,46.32089395,714.25,714.25,362,100
WHEAT-HRW - CHICAGO BOARD OF TRADE,8/3/2021,001612,225807,32934,114356,52947,6218,3608,59967,22862,34045,9518,10067,14249,207268,205405,18539,20402,-81422,-6607,-112533,29.37050394,46729,51971,18064,84.54006547,37105,63364,-59759,78.67254697,24527,49923,-2250,51.32348149,707.5,707.5,362,100
WHEAT-HRW - CHICAGO BOARD OF TRADE,7/27/2021,001612,213937,31480,106852,53380,6787,4234,54146,23252,30808,9450,9950,12520,196018,194403,17919,19534,-75372,-6607,-112533,35.0820384,46593,51971,18064,84.13896835,30894,63364,-59759,73.62799802,21358,49923,-2250,45.24945853,641.5,704.25,362,81.66544923
WHEAT-HRW - CHICAGO BOARD OF TRADE,7/20/2021,001612,203364,31469,106193,53861,7587,2917,51641,25028,21730,9877,8762,12695,184190,184912,19174,18452,-74724,-6607,-112533,35.69378623,46274,51971,18064,83.19815967,26613,63364,-59759,70.15098722,11853,49923,-2250,27.03122305,660.25,704.25,362,87.14390066
WHEAT-HRW - CHICAGO BOARD OF TRADE,7/13/2021,001612,195641,31317,94438,53226,9200,3707,50541,29941,21061,9466,8718,10318,179636,177383,16005,18258,-63121,-6607,-112533,46.64765969,44026,51971,18064,76.56826024,20600,63364,-59759,65.26725307,11595,49923,-2250,26.53671439,612.5,704.25,362,73.19211103
WHEAT-HRW - CHICAGO BOARD OF TRADE,7/6/2021,001612,188944,29153,90884,53430,9218,4455,47242,27177,20532,8750,8863,8876,172438,170005,16506,18939,-61731,-6607,-112533,47.95989653,44212,51971,18064,77.11681954,20065,63364,-59759,64.83272825,11782,49923,-2250,26.89513733,575.5,704.25,362,62.38130022
WHEAT-HRW - CHICAGO BOARD OF TRADE,6/29/2021,001612,183112,25552,87439,53553,10517,3608,46860,24679,22004,7797,7740,7769,167143,163756,15969,19356,-61887,-6607,-112533,47.81262391,43036,51971,18064,73.64850916,22181,63364,-59759,66.55133484,14207,49923,-2250,31.54313534,619,704.25,362,75.09130752
WHEAT-HRW - CHICAGO BOARD OF TRADE,6/22/2021,001612,199345,31795,87512,53941,10938,2980,44158,30329,24768,10519,7532,13387,181548,177446,17797,21899,-55717,-6607,-112533,53.63744501,43003,51971,18064,73.55118412,13829,63364,-59759,59.7678744,14249,49923,-2250,31.62363675,596.5,704.25,362,68.51716581
WHEAT-HRW - CHICAGO BOARD OF TRADE,6/15/2021,001612,203255,32921,88671,54069,10854,3763,48014,31408,22340,8625,8382,15668,185400,181086,17855,22169,-55750,-6607,-112533,53.60629118,43215,51971,18064,74.17642375,16606,63364,-59759,62.02334251,13715,49923,-2250,30.60011884,612.75,704.25,362,73.26515705
WHEAT-HRW - CHICAGO BOARD OF TRADE,6/8/2021,001612,208861,35354,95319,52477,10964,4370,48979,30002,26696,8192,7398,13218,189286,187967,19575,20894,-59965,-6607,-112533,49.62709816,41513,51971,18064,69.15681128,18977,63364,-59759,63.94905907,18504,49923,-2250,39.77919614,632.5,704.25,362,79.03579255
WHEAT-HRW - CHICAGO BOARD OF TRADE,6/1/2021,001612,221164,40140,99334,52455,9455,5684,50956,32571,34090,8690,7797,11989,204004,200920,17160,20244,-59194,-6607,-112533,50.35496479,43000,51971,18064,73.54233639,18385,63364,-59759,63.46823908,25400,49923,-2250,52.99676078,637.5,704.25,362,80.49671293
WHEAT-HRW - CHICAGO BOARD OF TRADE,5/25/2021,001612,224190,36980,99584,52823,9142,5608,54318,31024,38230,9244,8278,10428,207631,202294,16559,21896,-62604,-6607,-112533,47.13573627,43681,51971,18064,75.55077123,23294,63364,-59759,67.45530892,28986,49923,-2250,59.87004773,604.5,704.25,362,70.85463842
WHEAT-HRW - CHICAGO BOARD OF TRADE,5/18/2021,001612,224139,32951,102971,53630,9549,5155,60715,34769,34804,9368,6247,10115,206738,203610,17401,20529,-70020,-6607,-112533,40.13462228,44081,51971,18064,76.73046863,25946,63364,-59759,69.60925254,25436,49923,-2250,53.06576198,647.75,704.25,362,83.49159971
WHEAT-HRW - CHICAGO BOARD OF TRADE,5/11/2021,001612,226501,34382,109397,53225,10027,5346,67325,35417,31854,10141,6840,6403,208676,205284,17825,21217,-75015,-6607,-112533,35.41906614,43198,51971,18064,74.12628661,31908,63364,-59759,74.4515647,21713,49923,-2250,45.92988711,702.5,704.25,362,99.48867787
WHEAT-HRW - CHICAGO BOARD OF TRADE,5/4/2021,001612,223672,30979,108564,53531,9830,5245,66847,32670,32429,7863,6334,7794,204688,202866,18984,20806,-77585,-6607,-112533,32.99284406,43701,51971,18064,75.6097561,34177,63364,-59759,76.29443727,24566,49923,-2250,51.3982328,691,704.25,362,96.12856099
WHEAT-HRW - CHICAGO BOARD OF TRADE,4/27/2021,001612,219918,30980,108318,54400,8386,4297,60890,30779,33134,9215,7171,6230,199146,198315,20772,21603,-77338,-6607,-112533,33.22602572,46014,51971,18064,82.43135636,30111,63364,-59759,72.9920486,23919,49923,-2250,50.15812777,704.25,704.25,362,100
WHEAT-HRW - CHICAGO BOARD OF TRADE,4/20/2021,001612,215075,32716,100896,53072,7998,4357,52376,33768,32624,10687,7070,7901,193733,194614,21342,20461,-68180,-6607,-112533,41.87168401,45074,51971,18064,79.65906745,18608,63364,-59759,63.64935877,21937,49923,-2250,46.35922795,620.75,644,362,91.75531915
WHEAT-HRW - CHICAGO BOARD OF TRADE,4/13/2021,001612,221216,34046,94570,53545,8178,3544,51002,40227,31910,11970,7668,13963,199980,200060,21236,21156,-60524,-6607,-112533,49.09937126,45367,51971,18064,80.5231958,10775,63364,-59759,57.28742802,19940,49923,-2250,42.53157764,584.75,644,362,78.9893617
WHEAT-HRW - CHICAGO BOARD OF TRADE,4/6/2021,001612,232449,40341,93499,52277,10678,4461,51209,37274,35283,13322,14703,15489,212382,211387,20067,21062,-53158,-6607,-112533,56.05328248,41599,51971,18064,69.41044622,13935,63364,-59759,59.85396717,21961,49923,-2250,46.40522876,555.5,644,362,68.61702128
WHEAT-HRW - CHICAGO BOARD OF TRADE,3/30/2021,001612,225545,34988,94284,52867,10904,4549,52654,31469,35473,12486,14408,12673,205690,203760,19855,21785,-59296,-6607,-112533,50.25867115,41963,51971,18064,70.48397086,21185,63364,-59759,65.74238769,22987,49923,-2250,48.37176317,558.5,644,362,69.68085106
WHEAT-HRW - CHICAGO BOARD OF TRADE,3/23/2021,001612,220866,30837,97869,52634,9228,4641,53733,27662,34093,13667,14926,12090,201695,200509,19171,20357,-67032,-6607,-112533,42.95545947,43406,51971,18064,74.73972926,26071,63364,-59759,69.71077703,20426,49923,-2250,43.46309394,582,644,362,78.0141844
WHEAT-HRW - CHICAGO BOARD OF TRADE,3/16/2021,001612,216039,24660,101935,51937,9580,3649,59909,21614,36806,10917,15488,7841,195719,196913,20320,19126,-77275,-6607,-112533,33.2855012,42357,51971,18064,71.64597281,38295,63364,-59759,79.63906013,25889,49923,-2725,54.34964291,608.25,644,362,87.32269504
WHEAT-HRW - CHICAGO BOARD OF TRADE,3/9/2021,001612,217450,22736,108992,51549,9591,2690,63573,15948,36921,9721,8375,9601,196791,192118,20659,25332,-86256,-6607,-112533,24.80694069,41958,51971,18064,70.46922464,47625,63364,-59759,87.21684819,27200,49923,-2725,56.83976599,618,644,362,90.78014184
WHEAT-HRW - CHICAGO BOARD OF TRADE,3/2/2021,001612,223072,23124,112696,52073,9673,3668,65038,13354,40302,8565,8185,10066,202836,197944,20236,25128,-89572,-6607,-112533,21.67645337,42400,51971,18064,71.77279028,51684,63364,-59759,90.51355149,31737,49923,-2968,65.61607835,627,644,362,93.97163121
WHEAT-HRW - CHICAGO BOARD OF TRADE,2/23/2021,001612,228710,26281,121009,52376,9616,3861,64755,11564,35968,9265,13249,13368,205874,208635,22836,20075,-94728,-6607,-112533,16.80890433,42760,51971,18064,72.83451795,53191,63364,-59759,91.73753076,26703,49923,-2968,56.09839103,641,644,362,98.93617021
WHEAT-HRW - CHICAGO BOARD OF TRADE,2/16/2021,001612,229412,26794,126183,50171,7206,4312,67277,10601,34307,10467,12974,13204,206532,208787,22880,20625,-99389,-6607,-112533,12.40866265,42965,51971,18064,73.43911287,56676,63364,-59759,94.56803359,23840,49923,-4461,52.03920271,637.5,644,362,97.69503546
WHEAT-HRW - CHICAGO BOARD OF TRADE,2/9/2021,001612,227114,28025,128779,49116,7044,4366,68583,9131,31289,9824,13076,12996,204199,206681,22915,20433,-100754,-6607,-112533,11.12002719,42072,51971,18064,70.80543841,59452,63364,-59759,96.82268951,21465,49923,-4461,47.67210944,633.5,644,362,96.27659574
WHEAT-HRW - CHICAGO BOARD OF TRADE,2/2/2021,001612,223457,27731,125733,50507,6925,5362,69948,13547,29300,9444,12863,9919,202211,203649,21246,19808,-98002,-6607,-112533,13.71806733,43582,51971,18064,75.25879612,56401,63364,-59759,94.34467971,19856,49923,-4461,44.71351868,619,644,362,91.13475177
WHEAT-HRW - CHICAGO BOARD OF TRADE,1/26/2021,001612,220736,26509,128829,49719,6700,5177,70990,10751,30182,9344,12333,7852,199773,201824,20963,18912,-102320,-6607,-112533,9.641636614,43019,51971,18064,73.59837202,60239,63364,-59759,97.46188771,20838,49923,-4461,46.51919682,641,644,362,98.93617021
WHEAT-HRW - CHICAGO BOARD OF TRADE,1/19/2021,001612,218613,25323,128168,49908,8808,4822,68310,10217,27812,12654,10475,8688,197517,198990,21096,19623,-102845,-6607,-112533,9.14600759,41100,51971,18064,67.9387737,58093,63364,-59759,95.71891523,15158,49923,-4461,36.07494851,644,644,362,100
WHEAT-HRW - CHICAGO BOARD OF TRADE,1/12/2021,001612,223793,27691,130218,50496,7791,5863,67648,12586,27410,13196,10660,9935,202239,204463,21554,19330,-102527,-6607,-112533,9.44621717,42705,51971,18064,72.67230955,55062,63364,-59759,93.25714935,14214,49923,-4461,34.33914387,622.5,622.5,362,100
WHEAT-HRW - CHICAGO BOARD OF TRADE,1/5/2021,001612,220143,28834,130135,50568,7641,6880,66223,12780,23749,14782,10141,8164,199200,199490,20943,20653,-101301,-6607,-112533,10.60362895,42927,51971,18064,73.32704161,53443,63364,-59759,91.94220414,8967,49923,-4461,24.69108561,609.25,609.25,362,100
WHEAT-HRW - CHICAGO BOARD OF TRADE,12/29/2020,001612,215977,29452,129746,49475,8637,7007,63672,8988,23244,14135,10100,9353,196338,197075,19639,18902,-100294,-6607,-112533,11.55429262,40838,51971,18064,67.1660719,54684,63364,-59759,92.95013929,9109,49923,-4461,24.95219182,585,585,362,100
WHEAT-HRW - CHICAGO BOARD OF TRADE,12/21/2020,001612,211465,27094,127347,49671,5556,6497,60730,10008,24459,15457,9744,8655,192563,192266,18902,19199,-100253,-6607,-112533,11.59299889,44115,51971,18064,76.83074291,50722,63364,-59759,89.732219,9002,49923,-4461,24.75544278,574.5,579.5,362,97.70114943
WHEAT-HRW - CHICAGO BOARD OF TRADE,12/15/2020,001612,210488,27242,126312,50277,7726,6113,61495,9656,23893,13054,9169,8756,190830,191625,19658,18863,-99070,-6607,-112533,12.70981629,42551,51971,18064,72.21812605,51839,63364,-59759,90.63944186,10839,49923,-4461,28.13327449,566,579.5,362,93.79310345
WHEAT-HRW - CHICAGO BOARD OF TRADE,12/8/2020,001612,204707,26686,117557,49789,7874,3525,56883,12726,22818,13562,9195,12959,186222,186654,18485,18053,-90871,-6607,-112533,20.45012556,41915,51971,18064,70.34240717,44157,63364,-59759,84.40015269,9256,49923,-4461,25.22249191,536.25,579.5,362,80.11494253
WHEAT-HRW - CHICAGO BOARD OF TRADE,12/1/2020,001612,211611,28647,119780,49975,7618,3898,58719,14847,23057,13096,10160,14935,192327,194295,19284,17316,-91133,-6607,-112533,20.20278307,42357,51971,18064,71.64597281,43872,63364,-59759,84.16867685,9961,49923,-4461,26.51882907,537.5,579.5,362,80.68965517
WHEAT-HRW - CHICAGO BOARD OF TRADE,11/24/2020,001612,219910,29821,123537,50396,7051,4695,63229,15628,23336,12331,10851,16140,199948,201238,19962,18672,-93716,-6607,-112533,17.76428828,43345,51971,18064,74.5598254,47601,63364,-59759,87.19735549,11005,49923,-4461,28.43851133,561,579.5,362,91.49425287
WHEAT-HRW - CHICAGO BOARD OF TRADE,11/17/2020,001612,231577,33857,127637,48377,6932,6381,62487,16211,24896,19576,13578,16356,211930,211991,19647,19586,-93780,-6607,-112533,17.70386874,41445,51971,18064,68.95626272,46276,63364,-59759,86.12119588,5320,49923,-4461,17.98506914,552.5,579.5,362,87.5862069
WHEAT-HRW - CHICAGO BOARD OF TRADE,11/10/2020,001612,235355,36315,130154,47691,6157,6158,64524,18936,22757,19955,14228,17413,214813,215803,20542,19552,-93839,-6607,-112533,17.64816948,41534,51971,18064,69.21874539,45588,63364,-59759,85.56240507,2802,49923,-4461,13.35503089,561.5,579.5,362,91.72413793
WHEAT-HRW - CHICAGO BOARD OF TRADE,11/3/2020,001612,245752,34777,127383,50928,6062,8421,65763,20603,30698,17778,14349,17711,226076,225227,19676,20525,-92606,-6607,-112533,18.81218964,44866,51971,18064,79.0456248,45160,63364,-59759,85.21478521,12920,49923,-4461,31.95976758,557,579.5,362,89.65517241
WHEAT-HRW - CHICAGO BOARD OF TRADE,10/27/2020,001612,244147,39395,126150,50736,5783,7384,64169,24403,28887,17548,14342,17160,225279,224109,18868,20038,-86755,-6607,-112533,24.33585711,44953,51971,18064,79.30220898,39766,63364,-59759,80.83380035,11339,49923,-4461,29.05266255,549.25,579.5,362,86.09195402
WHEAT-HRW - CHICAGO BOARD OF TRADE,10/20/2020,001612,240042,37849,125066,51349,5297,5954,62104,25725,28579,17389,13410,16781,220005,220812,20037,19230,-87217,-6607,-112533,23.89970357,46052,51971,18064,82.54342761,36379,63364,-59759,78.08289272,11190,49923,-4461,28.77868491,571,579.5,362,96.09195402
WHEAT-HRW - CHICAGO BOARD OF TRADE,10/13/2020,001612,234894,34391,115306,51959,6080,6178,61364,30259,29907,16696,12342,14954,215449,215026,19445,19868,-80915,-6607,-112533,29.84913997,45879,51971,18064,82.03320848,31105,63364,-59759,73.79937136,13211,49923,-4461,32.49485143,531.25,579.5,362,77.81609195
WHEAT-HRW - CHICAGO BOARD OF TRADE,10/6/2020,001612,234349,34193,112581,51466,7537,5434,58133,31570,33478,19615,11604,12250,214569,214454,19780,19895,-78388,-6607,-112533,32.23476767,43929,51971,18064,76.28218362,26563,63364,-59759,70.11037743,13863,49923,-4461,33.69373345,534.25,579.5,362,79.1954023
WHEAT-HRW - CHICAGO BOARD OF TRADE,9/29/2020,001612,222930,38546,98931,51018,8100,3724,55013,37143,28882,16167,14747,11032,204382,202559,18548,20371,-60385,-6607,-112533,49.23059494,42918,51971,18064,73.30049842,17870,63364,-59759,63.04995817,12715,49923,-4461,31.58281848,476,579.5,362,52.4137931
WHEAT-HRW - CHICAGO BOARD OF TRADE,9/22/2020,001612,228069,37001,103666,52231,8108,3196,54943,36834,32270,17577,12565,12419,209637,209058,18432,19011,-66665,-6607,-112533,43.30192776,44123,51971,18064,76.85433686,18109,63364,-59759,63.244073,14693,49923,-6605,37.67690348,491.75,579.5,362,59.65517241
WHEAT-HRW - CHICAGO BOARD OF TRADE,9/15/2020,001612,229376,40507,102100,53192,7888,2985,52853,42844,33031,17518,11704,10969,211055,211521,18321,17855,-61593,-6607,-112533,48.09017616,45304,51971,18064,80.33739346,10009,63364,-59759,56.66528593,15513,49923,-6605,39.12751203,468,579.5,362,48.73563218
WHEAT-HRW - CHICAGO BOARD OF TRADE,9/8/2020,001612,226910,41953,106160,54091,7846,3502,52521,43775,28423,18478,11532,7772,206740,209010,20170,17900,-64207,-6607,-112533,45.62241565,46245,51971,18064,83.11263161,8746,63364,-59759,55.63948247,9945,49923,-6605,29.27752618,471.5,579.5,362,50.34482759
WHEAT-HRW - CHICAGO BOARD OF TRADE,9/1/2020,001612,223722,44521,109427,56222,7765,3220,52377,49512,18923,21173,11214,6768,203204,206829,20518,16893,-64906,-6607,-112533,44.96252101,48457,51971,18064,89.63635827,2865,63364,-59759,50.86295818,-2250,49923,-6605,7.704146618,483.5,579.5,362,55.86206897
WHEAT-HRW - CHICAGO BOARD OF TRADE,8/25/2020,001612,246340,57626,100070,55626,5229,3827,47247,68338,28640,20086,10006,11376,224428,227486,21912,18854,-42444,-6607,-112533,66.16789079,50397,51971,18064,95.3578907,-21091,63364,-59759,31.40599238,8554,49923,-6605,26.81679875,444.25,579.5,362,37.81609195
WHEAT-HRW - CHICAGO BOARD OF TRADE,8/18/2020,001612,254318,62184,93904,54897,7727,4750,43630,71384,29634,21357,11353,16413,232865,235165,21453,19153,-31720,-6607,-112533,76.29193966,47170,51971,18064,85.84068187,-27754,63364,-59759,25.99433087,8277,49923,-7377,27.31937173,430,579.5,362,31.26436782
WHEAT-HRW - CHICAGO BOARD OF TRADE,8/11/2020,001612,263114,65994,90328,55164,7628,3611,42404,77568,33177,22041,13054,17180,239571,242546,23543,20568,-24334,-6607,-112533,83.26473198,47536,51971,18064,86.92010499,-35164,63364,-59759,19.975959,11136,49923,-14097,39.41424555,416.75,579.5,362,25.17241379
WHEAT-HRW - CHICAGO BOARD OF TRADE,8/4/2020,001612,271336,64813,98301,56747,7711,3570,45294,71761,37928,22486,14569,17888,248726,251728,22610,19608,-33488,-6607,-112533,74.62284991,49036,51971,18064,91.34397027,-26467,63364,-59759,27.03962704,15442,49923,-14097,46.14026867,422.25,579.5,362,27.70114943
WHEAT-HRW - CHICAGO BOARD OF TRADE,7/28/2020,001612,267660,64350,100772,55915,8186,2313,46175,66625,40842,20347,14401,16925,246867,250064,20793,17596,-36422,-6607,-112533,71.85299171,47729,51971,18064,87.48930899,-20450,63364,-59759,31.92660998,20495,49923,-16171,55.47553484,436.75,579.5,362,34.36781609
WHEAT-HRW - CHICAGO BOARD OF TRADE,7/21/2020,001612,261941,64353,97349,53930,8223,2234,47468,67214,39125,17756,13710,16407,241273,244262,20668,17679,-32996,-6607,-123315,77.38886794,45707,51971,18064,81.5259386,-19746,63364,-59759,32.49839591,21369,49923,-16171,56.79789391,442.5,579.5,362,37.01149425
WHEAT-HRW - CHICAGO BOARD OF TRADE,7/14/2020,001612,248761,70290,94738,51288,7457,2271,43207,68470,36597,15809,12356,9146,228608,231035,20153,17726,-24448,-6607,-130381,85.58582578,43831,51971,18064,75.99315776,-25263,70751,-59759,26.43169106,20788,49923,-16171,55.91884286,438.25,579.5,362,35.05747126
WHEAT-HRW - CHICAGO BOARD OF TRADE,7/7/2020,001612,240418,69422,82483,49516,7521,4039,38411,72414,35096,16988,11987,7427,220899,220967,19519,19451,-13061,-6607,-130381,94.78565773,41995,51971,18064,70.57834665,-34003,72845,-59759,19.42324515,18108,49923,-16171,51.86401186,436,579.5,362,34.02298851
WHEAT-HRW - CHICAGO BOARD OF TRADE,6/30/2020,001612,235012,68628,77717,50632,6956,3818,35216,71958,36374,13550,12135,7050,215268,216008,19744,19004,-9089,-6607,-130381,97.99473233,43676,51971,18064,75.53602501,-36742,72845,-59759,17.3576966,22824,49923,-16171,58.99930402,435.5,579.5,362,33.79310345
WHEAT-HRW - CHICAGO BOARD OF TRADE,6/23/2020,001612,242093,69825,79846,49467,3368,4849,34482,71989,37412,15442,12725,9179,220656,219368,21437,22725,-10021,-6607,-130381,97.24174706,46099,51971,18064,82.68204206,-37507,72845,-59759,16.78079093,21970,49923,-16171,57.70720489,435,579.5,362,33.56321839
WHEAT-HRW - CHICAGO BOARD OF TRADE,6/16/2020,001612,232612,64716,81281,50679,3311,3695,33000,60655,36930,13734,14992,9182,211936,210046,20676,22566,-16565,-6607,-130381,91.95469162,47368,51971,18064,86.42463208,-27655,72845,-59759,24.21043106,23196,49923,-16171,59.56213877,438.25,579.5,362,35.05747126
WHEAT-HRW - CHICAGO BOARD OF TRADE,6/9/2020,001612,224805,56039,80532,50086,3291,3972,34499,53348,33915,11166,13172,13874,203551,202104,21254,22701,-24493,-6607,-130381,85.54946919,46795,51971,18064,84.73471555,-18849,72845,-59759,30.85125637,22749,49923,-16171,58.88582927,457.75,579.5,362,44.02298851
WHEAT-HRW - CHICAGO BOARD OF TRADE,6/2/2020,001612,229286,59776,81340,49371,3523,5431,33698,57979,37153,13213,13279,10551,209193,209256,20093,20030,-21564,-6607,-130381,87.91587894,45848,51971,18064,81.94178193,-24281,72845,-59759,26.75484902,23940,49923,-16171,60.68780827,450.75,579.5,362,40.8045977
WHEAT-HRW - CHICAGO BOARD OF TRADE,5/26/2020,001612,231409,62305,82204,47488,4005,5668,32829,58487,39033,13187,12668,10267,210777,212332,20632,19077,-19899,-6607,-130381,89.2610726,43483,51971,18064,74.96682101,-25658,72845,-59759,25.71641881,25846,49923,-16171,63.57157987,447.25,579.5,362,39.1954023
WHEAT-HRW - CHICAGO BOARD OF TRADE,5/19/2020,001612,223245,55518,85697,48638,3942,5077,31213,46316,37677,13860,13752,10826,202809,203287,20436,19958,-30179,-6607,-130381,80.95561265,44696,51971,18064,78.5442534,-15103,72845,-59759,33.67620886,23817,49923,-16171,60.50170969,441.5,579.5,362,36.55172414
WHEAT-HRW - CHICAGO BOARD OF TRADE,5/12/2020,001612,210147,44610,92564,50441,4406,5066,34713,31164,33054,12028,13282,10487,190399,190023,19748,20124,-47954,-6607,-130381,66.59476142,46035,51971,18064,82.49329047,3549,72845,-59759,47.74214956,21026,49923,-16171,56.27893606,483.5,579.5,362,55.86206897
WHEAT-HRW - CHICAGO BOARD OF TRADE,5/5/2020,001612,218014,44226,98379,50016,4530,4849,38273,30594,36698,13182,12775,11459,198703,199284,19311,18730,-54153,-6607,-130381,61.5864398,45486,51971,18064,80.87415578,7679,72845,-59759,50.85668607,23516,49923,-16171,60.0462977,483,579.5,362,55.63218391
WHEAT-HRW - CHICAGO BOARD OF TRADE,4/28/2020,001612,221005,45660,97468,49814,4851,4332,38385,32966,36399,14432,13323,11990,201012,201329,19993,19676,-51808,-6607,-130381,63.48102186,44963,51971,18064,79.33170142,5419,72845,-59759,49.15236343,21967,49923,-16171,57.7026659,474.5,579.5,362,51.72413793
WHEAT-HRW - CHICAGO BOARD OF TRADE,4/21/2020,001612,232939,48354,102610,47075,5162,4201,41091,30371,40520,15267,13628,15669,212177,212161,20762,20778,-54256,-6607,-130381,61.50322362,41913,51971,18064,70.33650869,10720,72845,-59759,53.14998039,25253,49923,-16171,62.67437286,496.75,579.5,362,61.95402299
WHEAT-HRW - CHICAGO BOARD OF TRADE,4/14/2020,001612,234038,47338,99249,46604,4540,4225,38651,33514,37319,17673,14557,20350,212160,213754,21878,20284,-51911,-6607,-130381,63.39780568,42064,51971,18064,70.78184446,5137,72845,-59759,48.93970016,19646,49923,-17805,55.29618474,483.75,579.5,362,55.97701149
WHEAT-HRW - CHICAGO BOARD OF TRADE,4/7/2020,001612,226234,47544,98417,47362,4624,4990,38418,36449,30369,18659,14000,17695,205037,206544,21197,19690,-50873,-6607,-130381,64.23643091,42738,51971,18064,72.76963459,1969,72845,-59759,46.55063196,11710,49923,-17805,43.57872667,473.25,579.5,362,51.14942529
WHEAT-HRW - CHICAGO BOARD OF TRADE,3/31/2020,001612,226797,45380,99288,51418,4604,5306,39417,37125,29183,18003,13683,16725,205432,205914,21365,20883,-53908,-6607,-130381,61.78438121,46814,51971,18064,84.79075117,2292,72845,-59759,46.79421435,11180,49923,-17805,42.79618474,493,579.5,362,60.22988506
WHEAT-HRW - CHICAGO BOARD OF TRADE,3/24/2020,001612,223516,48593,94497,55642,4725,5046,35355,41278,30419,12085,11333,15674,202814,202972,20702,20544,-45904,-6607,-130381,68.25100587,50917,51971,18064,96.89149733,-5923,72845,-59759,40.59907695,18334,49923,-17805,53.35902433,490.75,579.5,362,59.1954023
WHEAT-HRW - CHICAGO BOARD OF TRADE,3/17/2020,001612,256823,57504,93589,51953,4441,6479,39985,53504,47764,14244,12615,16465,234394,234857,22429,21966,-36085,-6607,-130381,76.1840128,47512,51971,18064,86.84932315,-13519,72845,-59759,34.87074296,33520,49923,-17805,75.78106544,432.25,579.5,362,32.29885057
WHEAT-HRW - CHICAGO BOARD OF TRADE,3/10/2020,001612,269265,54369,92606,52412,4074,5272,48612,63596,52381,15133,13057,17473,245652,248459,23613,20806,-38237,-6607,-130381,74.44536009,48338,51971,18064,89.2853983,-14984,72845,-59759,33.76594975,37248,49923,-17805,81.28543586,443.25,579.5,362,37.35632184
WHEAT-HRW - CHICAGO BOARD OF TRADE,3/3/2020,001612,250643,49679,96838,50486,4555,5386,53648,55712,41004,14336,13844,13014,227553,230353,23090,20290,-47159,-6607,-130381,67.2370611,45931,51971,18064,82.18656915,-2064,72845,-59759,43.50924557,26668,49923,-17805,65.6641271,452,579.5,362,41.37931034
WHEAT-HRW - CHICAGO BOARD OF TRADE,2/25/2020,001612,267971,52350,106400,50137,6444,5148,54852,46682,51477,13163,13773,15709,242836,245633,25135,22338,-54050,-6607,-130381,61.66965599,43693,51971,18064,75.58616215,8170,72845,-59759,51.22696148,38314,49923,-17805,82.85937869,455,579.5,362,42.75862069
WHEAT-HRW - CHICAGO BOARD OF TRADE,2/18/2020,001612,284730,53328,116116,49894,6500,5130,59474,45787,55688,17028,15750,18253,258795,263224,25935,21506,-62788,-6607,-130381,54.61001503,43394,51971,18064,74.70433834,13687,72845,-59759,55.38746946,38660,49923,-17805,83.37024569,485.75,579.5,362,56.89655172
WHEAT-HRW - CHICAGO BOARD OF TRADE,2/11/2020,001612,290843,54999,118476,52026,6189,6796,56761,46778,56185,17302,15286,20142,264211,269852,26632,20991,-63477,-6607,-130381,54.05335531,45837,51971,18064,81.90934025,9983,72845,-59759,52.59419022,38883,49923,-17805,83.6995039,468.25,579.5,362,48.85057471
WHEAT-HRW - CHICAGO BOARD OF TRADE,2/4/2020,001612,304577,56331,118032,53170,5816,6363,55103,47219,58159,17944,15565,31524,278594,282678,25983,21899,-61701,-6607,-130381,55.48822855,47354,51971,18064,86.38334267,7884,72845,-59759,51.01128171,40215,49923,-17805,85.66619419,467.25,579.5,362,48.3908046
WHEAT-HRW - CHICAGO BOARD OF TRADE,1/28/2020,001612,302135,51946,120137,54707,5068,5025,54551,45766,56462,17561,15194,34952,275204,282604,26931,19531,-68191,-6607,-130381,50.24480101,49639,51971,18064,93.12236411,8785,72845,-59759,51.69074839,38901,49923,-17805,83.72608079,482,579.5,362,55.17241379
WHEAT-HRW - CHICAGO BOARD OF TRADE,1/21/2020,001612,287184,49481,121542,56322,4351,4108,53005,43388,50696,17308,13545,29878,260798,267508,26386,19676,-72061,-6607,-130381,47.11813466,51971,51971,18064,100,9617,72845,-59759,52.31818045,33388,49923,-17805,75.5861682,500,579.5,362,63.44827586
WHEAT-HRW - CHICAGO BOARD OF TRADE,1/14/2020,001612,283392,46966,117237,56001,4304,4064,52271,45747,52646,16584,11303,28382,256914,263683,26478,19709,-70271,-6607,-130381,48.56431884,51697,51697,18064,100,6524,72845,-59759,49.98567162,36062,49923,-17805,79.53431373,497,579.5,362,62.06896552
WHEAT-HRW - CHICAGO BOARD OF TRADE,1/7/2020,001612,267769,48741,111515,49067,3264,3029,48631,46624,52037,16909,10443,22244,240658,249156,27111,18613,-62774,-6607,-130381,54.62132597,45803,47122,18064,95.46080253,2007,72845,-59759,46.57928871,35128,49923,-17805,78.15526813,475,579.5,362,51.95402299
WHEAT-HRW - CHICAGO BOARD OF TRADE,12/31/2019,001612,264957,48414,108418,46895,3339,2900,50544,50225,53399,17688,9559,19080,238920,246920,26037,18037,-60004,-6607,-130381,56.85927578,43556,47122,18064,87.72799229,319,72845,-59759,45.3063256,35711,49923,-17805,79.01606426,486,579.5,362,57.01149425
WHEAT-HRW - CHICAGO BOARD OF TRADE,12/24/2019,001612,271285,48403,104226,45694,3214,2828,54034,59646,55197,20056,9176,18859,245071,253146,26214,18139,-55823,-6607,-130381,60.23720652,42480,47122,18064,84.02505334,-5612,72845,-59759,40.83360985,35141,49923,-17805,78.17446256,460.5,579.5,362,45.28735632
WHEAT-HRW - CHICAGO BOARD OF TRADE,12/17/2019,001612,279097,49708,100868,40544,5319,3138,60000,69309,53594,25156,8522,20442,252582,261192,26515,17905,-51160,-6607,-130381,64.00455669,35225,47122,18064,59.05774658,-9309,72845,-59759,38.04560948,28438,49923,-17805,68.27752185,467,579.5,362,48.27586207
WHEAT-HRW - CHICAGO BOARD OF TRADE,12/10/2019,001612,271617,50602,86742,39809,5411,3541,56178,80593,49878,24618,7406,20133,244759,253704,26858,17913,-36140,-6607,-130381,76.13957697,34398,47122,18064,56.2117145,-24415,72845,-59759,26.65379627,25260,49923,-17805,63.58522325,416,579.5,362,24.82758621
WHEAT-HRW - CHICAGO BOARD OF TRADE,12/3/2019,001612,265571,48316,92398,40805,5170,3620,56256,70737,50113,22214,6392,19250,240574,247680,24997,17891,-44082,-6607,-130381,69.72304361,35635,47122,18064,60.46871774,-14481,72845,-59759,34.14527465,27899,49923,-17805,67.48169147,422.5,579.5,362,27.81609195
WHEAT-HRW - CHICAGO BOARD OF TRADE,11/26/2019,001612,260836,53277,91603,41315,7048,3622,56602,73622,44507,21799,6261,15017,236139,241680,24697,19156,-38326,-6607,-130381,74.37345485,34267,47122,18064,55.76089201,-17020,72845,-59759,32.23055111,22708,49923,-17805,59.81721002,432.5,579.5,362,32.4137931
WHEAT-HRW - CHICAGO BOARD OF TRADE,11/19/2019,001612,286418,62365,96847,40383,7285,5005,53126,79703,51198,26981,7193,19035,258093,266266,28325,20152,-34482,-6607,-130381,77.47911516,33098,47122,18064,51.7379035,-26577,72845,-59759,25.02337788,24217,49923,-17805,62.04523978,425.75,579.5,362,29.31034483
WHEAT-HRW - CHICAGO BOARD OF TRADE,11/12/2019,001612,302398,64342,105883,43610,7160,4862,56496,80340,57721,28789,7421,18862,274682,282249,27716,20149,-41541,-6607,-130381,71.7759788,36450,47122,18064,63.27345309,-23844,72845,-59759,27.08440168,28932,49923,-17805,69.00690999,438.75,579.5,362,35.28735632
WHEAT-HRW - CHICAGO BOARD OF TRADE,11/5/2019,001612,314020,65881,96239,42023,7096,10906,51863,86780,64840,28009,7079,22149,285671,295089,28349,18931,-30358,-6607,-130381,80.81099423,34927,47122,18064,58.03221144,-34917,72845,-59759,18.73397484,36831,49923,-17805,80.66973777,428.5,579.5,362,30.57471264
WHEAT-HRW - CHICAGO BOARD OF TRADE,10/29/2019,001612,313557,65930,93626,36685,9630,11306,52700,83133,68757,28358,6748,21542,285278,294742,28279,18815,-27696,-6607,-130381,82.96168824,27055,47122,18064,30.94156515,-30433,72845,-59759,22.11547163,40399,49923,-17805,85.93786912,419,579.5,362,26.20689655
WHEAT-HRW - CHICAGO BOARD OF TRADE,10/22/2019,001612,298578,67196,98873,37503,9706,5147,52366,79443,61277,30341,7348,18092,271922,279886,26656,18692,-31677,-6607,-130381,79.74534232,27797,47122,18064,33.49507881,-27077,72845,-59759,24.64631534,30936,49923,-17805,71.96580439,421.25,579.5,362,27.24137931
WHEAT-HRW - CHICAGO BOARD OF TRADE,10/15/2019,001612,319437,76900,109444,35438,10953,6226,58043,82785,66576,30768,7131,18002,291953,301117,27484,18320,-32544,-6607,-130381,79.04487211,24485,47122,18064,22.09718494,-24742,72845,-59759,26.40719737,35808,49923,-17805,79.1592842,421.25,579.5,362,27.24137931
WHEAT-HRW - CHICAGO BOARD OF TRADE,10/8/2019,001612,313449,78836,98982,31720,10826,4686,53364,89324,69084,31484,7255,14640,283814,294797,29635,18652,-20146,-6607,-130381,89.06151534,20894,47122,18064,9.739142405,-35960,72845,-59759,17.9474224,37600,49923,-17805,81.80516182,410.25,579.5,362,22.18390805
WHEAT-HRW - CHICAGO BOARD OF TRADE,10/1/2019,001612,307958,73763,95437,30953,12889,4622,51678,85352,73229,35353,7732,10589,280187,289850,27771,18108,-21674,-6607,-130381,87.82700729,18064,47122,18064,0,-33674,72845,-59759,19.6713523,37876,49923,-17805,82.21267423,411.5,579.5,362,22.75862069
WHEAT-HRW - CHICAGO BOARD OF TRADE,9/24/2019,001612,299357,72243,92841,33187,9498,5348,48555,85358,69658,32786,7660,10513,272290,280876,27067,18481,-20598,-6607,-130381,88.69633364,23689,47122,21952,6.901072706,-36803,72845,-59759,17.31169497,36872,49923,-17805,80.73027404,405,579.5,362,19.77011494
WHEAT-HRW - CHICAGO BOARD OF TRADE,9/17/2019,001612,292374,69118,87659,33200,9887,6094,46906,84511,66198,33480,9121,10516,265512,273986,26862,18388,-18541,-6607,-130381,90.35823355,23313,47122,21952,5.40723083,-37605,72845,-59759,16.70688667,32718,49923,-17805,74.59691708,402.25,579.5,362,18.50574713
WHEAT-HRW - CHICAGO BOARD OF TRADE,9/10/2019,001612,295271,71850,86521,31837,9326,8807,46181,87890,65406,33977,9514,9732,267790,277196,27481,18075,-14671,-6607,-130381,93.4848999,22511,47122,21952,2.220897894,-41709,72845,-59759,13.61195741,31429,49923,-17805,72.69371604,382,579.5,362,9.195402299
WHEAT-HRW - CHICAGO BOARD OF TRADE,9/3/2019,001612,285852,80353,87503,30798,8846,7836,43097,88141,54821,34482,11566,9085,260472,267798,25380,18054,-7150,-6607,-130381,99.5612972,21952,47122,21952,0,-45044,72845,-59759,11.09695032,20339,49923,-17805,56.31939523,362,579.5,362,0
WHEAT-HRW - CHICAGO BOARD OF TRADE,8/27/2019,001612,287854,85145,101235,31767,6172,7031,44919,82249,52792,31495,10315,9277,262426,269071,25428,18783,-16090,-6607,-130381,92.33845557,25595,47122,23128,10.2817371,-37330,72845,-59759,16.91427106,21297,49923,-17805,57.73387668,392.75,579.5,367.75,11.80637544
WHEAT-HRW - CHICAGO BOARD OF TRADE,8/20/2019,001612,293109,84851,101557,32493,6154,6925,42073,82477,51167,35214,10997,13369,266092,272646,27017,20463,-16706,-6607,-130381,91.84077431,26339,47122,23128,13.38251229,-40404,72845,-59759,14.59609062,15953,49923,-17805,49.84349161,386.75,579.5,367.75,8.972845336
WHEAT-HRW - CHICAGO BOARD OF TRADE,8/13/2019,001612,290450,82824,100858,30199,6105,8556,42995,79430,49542,35994,12012,13163,263273,269666,27177,20784,-18034,-6607,-130381,90.76785108,24094,47122,23128,4.026006502,-36435,72845,-59759,17.589213,13548,49923,-17805,46.29252303,383.5,579.5,367.75,7.438016529
WHEAT-HRW - CHICAGO BOARD OF TRADE,8/6/2019,001612,291051,74980,101317,31415,5828,9790,50666,73608,52976,30276,11256,15098,265201,269873,25850,21178,-26337,-6607,-130381,84.05965712,25587,47122,23128,10.24839543,-22942,72845,-59759,27.76462248,22700,49923,-17805,59.80539806,418,579.5,367.75,23.73081464
WHEAT-HRW - CHICAGO BOARD OF TRADE,7/30/2019,001612,287743,71400,103110,31386,8121,7892,52083,68366,54639,27891,10240,15313,260604,267681,27139,20062,-31710,-6607,-130381,79.71868082,23265,47122,23128,0.570976077,-16283,72845,-59759,32.78634129,26748,49923,-17805,65.78224663,433.5,579.5,367.75,31.05076741
WHEAT-HRW - CHICAGO BOARD OF TRADE,7/23/2019,001612,286207,71615,98148,31401,8273,7893,48086,68930,58001,28317,11066,13849,259162,266160,27045,20047,-26533,-6607,-130381,83.90130399,23128,47122,23128,0,-20844,72845,-59759,29.34677687,29684,49923,-17805,70.11723364,431.5,579.5,367.75,30.10625738
WHEAT-HRW - CHICAGO BOARD OF TRADE,7/16/2019,001612,280333,70106,99417,31589,8164,8031,48571,65761,55155,26716,9150,13408,253576,259086,26757,21247,-29311,-4329,-130381,80.18119506,23425,47122,19367,14.62078905,-17190,72845,-59759,32.10234985,28439,49923,-17805,68.27899835,446.25,579.5,367.75,37.07201889
WHEAT-HRW - CHICAGO BOARD OF TRADE,7/9/2019,001612,277477,71083,95880,32752,8258,7776,45801,64048,53693,24974,9392,16191,252270,255238,25207,22239,-24797,-3072,-130381,82.9352206,24494,47122,19250,18.81458094,-18247,72845,-59759,31.30523966,28719,49923,-17805,68.69241673,440.5,579.5,367.75,34.35655254
WHEAT-HRW - CHICAGO BOARD OF TRADE,7/2/2019,001612,269299,71031,96645,32368,6117,7185,42314,62135,52928,25009,8380,13743,244578,247133,24721,22166,-25614,-3072,-130381,82.29347493,26251,47122,19250,25.11839839,-19821,72845,-59759,30.11824681,27919,49923,-17805,67.51122136,424,579.5,367.75,26.56434475
WHEAT-HRW - CHICAGO BOARD OF TRADE,6/25/2019,001612,261016,65929,97781,34002,1848,7711,40732,58890,50916,22267,7311,14507,236064,238964,24952,22052,-31852,-3072,-130381,77.39358569,32154,47122,19250,46.29735936,-18158,72845,-59759,31.37235679,28649,49923,-17805,68.58906213,465.25,579.5,367.75,46.04486423
WHEAT-HRW - CHICAGO BOARD OF TRADE,6/18/2019,001612,286494,66271,94511,32407,4679,13803,45174,66967,61862,25475,7770,14604,259596,264196,26898,22298,-28240,-3072,-130381,80.23077709,27728,47122,19250,30.41762342,-21793,72845,-59759,28.63111218,36387,49923,-17805,80.01417434,465.25,579.5,367.75,46.04486423
WHEAT-HRW - CHICAGO BOARD OF TRADE,6/11/2019,001612,299794,69300,98464,33722,4987,12651,45971,70368,70517,25857,6704,14511,272529,278202,27265,21592,-29164,-3072,-130381,79.50498394,28735,47122,19250,34.03056831,-24397,72845,-59759,26.66737052,44660,49923,-17805,92.22921096,457.5,579.5,367.75,42.38488784
WHEAT-HRW - CHICAGO BOARD OF TRADE,6/4/2019,001612,305542,66421,93933,34227,4814,14703,47118,72278,72324,25899,6851,17885,278577,282788,26965,22754,-27512,-3072,-130381,80.80261411,29413,47122,19250,36.46311711,-25160,72845,-59759,26.09197309,46425,49923,-17805,94.83522325,468.5,579.5,367.75,47.57969303
WHEAT-HRW - CHICAGO BOARD OF TRADE,5/28/2019,001612,328319,72279,94262,36190,5446,15957,50850,91224,73869,28725,6422,20572,298442,307752,29877,20567,-21983,-3072,-130381,85.14559065,30744,47122,19250,41.23851894,-40374,72845,-59759,14.61871437,45144,49923,-17805,92.94383416,460.75,579.5,367.75,43.91971665
WHEAT-HRW - CHICAGO BOARD OF TRADE,5/21/2019,001612,332677,74198,92752,35779,3134,11480,51991,101127,79365,29442,6022,18486,300741,312366,31936,20311,-18554,-3072,-130381,87.8390373,32645,47122,19250,48.05898393,-49136,72845,-59759,8.011070556,49923,49923,-17805,100,436,579.5,367.75,32.23140496
WHEAT-HRW - CHICAGO BOARD OF TRADE,5/14/2019,001612,340246,79354,90752,35425,3142,16108,53379,110577,72620,29564,5078,21078,307528,319355,32718,20891,-11398,-3072,-130381,93.46000676,32283,47122,19250,46.76018944,-57198,72845,-59759,1.931314289,43056,43056,-17805,100,401.75,579.5,367.75,16.0566706
WHEAT-HRW - CHICAGO BOARD OF TRADE,5/7/2019,001612,330843,79658,88169,34278,2312,12943,56877,116636,65640,29537,5743,18048,296981,309491,33862,21352,-8511,-3072,-130381,95.7277176,31966,47122,19250,45.6228473,-59759,72845,-59759,0,36103,37735,-17805,97.06157724,394.75,579.5,367.75,12.75088548
WHEAT-HRW - CHICAGO BOARD OF TRADE,4/30/2019,001612,325496,77194,83801,35247,3772,13274,57602,117242,60676,29903,6304,18287,292183,303356,33313,22140,-6607,-3072,-130381,97.22329136,31475,47122,19250,43.86122273,-59640,72845,-59640,0,30773,37735,-17805,87.46489017,386.25,579.5,367.75,8.736717828
WHEAT-HRW - CHICAGO BOARD OF TRADE,4/23/2019,001612,335498,83242,93217,36660,6250,12903,59121,114315,58741,29642,5641,21609,301918,312676,33580,22822,-9975,-3072,-130381,94.57775962,30410,47122,19250,40.0401837,-55194,72845,-55414,0.171527924,29099,37735,-17805,84.45084624,414.5,579.5,367.75,22.07792208
WHEAT-HRW - CHICAGO BOARD OF TRADE,4/16/2019,001612,319362,76635,88598,39075,7381,6485,56369,111783,55946,28887,6240,21159,284556,297592,34806,21770,-11963,-3072,-130381,93.01620467,31694,47122,19250,44.64695752,-55414,72845,-55414,0,27059,37735,-17805,80.77781779,417,579.5,367.75,23.25855962
WHEAT-HRW - CHICAGO BOARD OF TRADE,4/9/2019,001612,327373,76509,93979,38590,7421,8329,57315,106312,60960,25280,5766,23195,290178,305962,37195,21411,-17470,-149,-130381,86.69988943,31169,47122,19250,42.76334673,-48997,72845,-52693,2.944128471,35680,37735,-17805,96.29996399,427.5,579.5,367.75,28.21723731
WHEAT-HRW - CHICAGO BOARD OF TRADE,4/2/2019,001612,339363,81998,95196,38853,7413,10795,58749,109303,62364,24629,6516,26427,303815,318014,35548,21349,-13198,-149,-130381,89.9801892,31440,47122,19250,43.73564868,-50554,72845,-52693,1.703866558,37735,37735,-17805,100,433.25,579.5,367.75,30.93270366
WHEAT-HRW - CHICAGO BOARD OF TRADE,3/26/2019,001612,331020,83829,101968,38535,6697,10010,58483,108053,55991,28079,5511,22446,297373,310676,33647,20344,-18139,-149,-130381,86.1861908,31838,47122,19250,45.16360505,-49570,72845,-52693,2.487692969,27912,27912,-17805,100,443.25,579.5,367.75,35.65525384
WHEAT-HRW - CHICAGO BOARD OF TRADE,3/19/2019,001612,323818,86548,99286,38175,6896,7832,57793,110486,54604,28743,5444,18321,292016,302869,31802,20949,-12738,-149,-130381,90.333405,31279,47122,19250,43.15800804,-52693,72845,-52693,0,25861,26581,-17805,98.37786689,435.75,579.5,367.75,32.1133412
WHEAT-HRW - CHICAGO BOARD OF TRADE,3/12/2019,001612,311292,77674,95199,40546,6813,7907,59230,110580,48609,28166,5438,17198,279330,291744,31962,19548,-17525,-149,-130381,86.6576571,33733,47122,19250,51.96254305,-51350,72845,-51350,0,20443,26581,-17805,86.17131528,435.75,579.5,367.75,32.1133412
WHEAT-HRW - CHICAGO BOARD OF TRADE,3/5/2019,001612,297996,72582,94684,41643,6705,3832,64268,110946,42347,26626,6187,13709,265007,278410,32989,19586,-22102,-149,-130381,83.1431599,34938,47122,19250,56.2858783,-46678,72845,-46678,0,15721,26581,-17805,75.53282567,444,579.5,367.75,36.0094451
WHEAT-HRW - CHICAGO BOARD OF TRADE,2/26/2019,001612,290253,71954,93380,42090,6745,7133,60624,104002,38421,23695,7388,12780,256697,269849,33556,20404,-21426,2591,-130381,81.9383028,35345,47122,19250,57.74612514,-43378,72845,-43378,0,14726,26581,-17805,73.29112783,435.75,579.5,367.75,32.1133412
WHEAT-HRW - CHICAGO BOARD OF TRADE,2/19/2019,001612,304375,70983,105013,43357,6990,10819,64791,96888,36254,27129,9066,17634,270967,282664,33408,21711,-34030,2988,-130381,72.24392475,36367,47122,19250,61.41288749,-32097,72845,-34476,2.216714343,9125,26581,-17805,60.67228405,460.75,579.5,367.75,43.91971665
WHEAT-HRW - CHICAGO BOARD OF TRADE,2/12/2019,001612,292934,66633,108552,46947,6956,11099,61431,87122,32979,24707,7731,16090,259886,270529,33048,22405,-41919,4247,-130381,65.70847075,39991,47122,19250,74.4151837,-25691,72845,-34476,8.185723204,8272,26581,-17805,58.75050692,492,579.5,367.75,58.67768595
WHEAT-HRW - CHICAGO BOARD OF TRADE,2/5/2019,001612,303201,73331,122621,45073,4887,14521,64567,80081,36860,24116,8721,14659,273127,282350,30074,20851,-49290,4247,-130381,60.23338384,40186,47122,19250,75.11481056,-15514,72845,-34476,17.66848986,12744,26581,-17805,68.82575587,511.25,579.5,367.75,67.76859504
WHEAT-HRW - CHICAGO BOARD OF TRADE,1/29/2019,001612,297685,68979,120445,41838,4210,15992,66080,76361,36823,24714,8558,13707,268133,276096,29552,21589,-51466,4247,-130381,58.61707817,37628,47122,19250,65.93714122,-10281,72845,-34476,22.54451598,12109,26581,-17805,67.39512459,500.25,579.5,367.75,62.57378985
WHEAT-HRW - CHICAGO BOARD OF TRADE,1/22/2019,001612,297269,68548,127569,42726,2665,11595,69834,75214,39440,24379,9451,11446,267968,277380,29301,19889,-59021,4247,-130381,53.00531836,40061,47122,19250,74.6663318,-5380,72845,-34476,27.1111898,15061,26581,-17805,74.04587032,509.75,579.5,367.75,67.06021251
WHEAT-HRW - CHICAGO BOARD OF TRADE,1/15/2019,001612,301004,67512,115328,46063,7396,11589,62172,76581,48563,24197,9450,10937,271033,279844,29971,21160,-47816,4247,-130381,61.32825267,38667,47122,19250,69.66489667,-14409,72845,-34476,18.69811127,24366,26581,-17805,95.00968774,495.5,579.5,367.75,60.33057851
WHEAT-HRW - CHICAGO BOARD OF TRADE,1/8/2019,001612,300497,65765,121421,47949,7612,8371,65707,72954,47974,23808,9546,12159,271733,280037,28764,20460,-55656,4247,-130381,55.50479841,40337,47122,19250,75.6565729,-7247,72845,-34476,25.3715489,24166,26581,-17805,94.55909521,505,579.5,367.75,64.81700118
WHEAT-HRW - CHICAGO BOARD OF TRADE,12/31/2018,001612,294617,60453,116482,47972,7462,8909,69678,74334,48324,23478,10806,8393,267207,274710,27410,19907,-56029,4247,-130381,55.22773866,40510,47122,19250,76.27726751,-4656,72845,-34476,27.78580147,24846,26581,-17805,96.09110981,488.75,579.5,367.75,57.14285714
WHEAT-HRW - CHICAGO BOARD OF TRADE,12/24/2018,001612,287580,55031,115065,47835,7497,9123,69765,69907,49035,22454,9241,7190,260433,267058,27147,20522,-60034,4247,-130381,52.25287459,40338,47122,19250,75.66016073,-142,72845,-34476,31.99187484,26581,26581,-17805,100,502.5,579.5,367.75,63.63636364
WHEAT-HRW - CHICAGO BOARD OF TRADE,12/18/2018,001612,288160,53208,119820,46986,4643,7817,74898,70990,47093,22979,8801,8098,261079,267262,27081,20898,-66612,4247,-130381,47.3668182,42343,47122,19250,82.85376005,3908,72845,-34476,35.7656004,24114,24304,-17805,99.54879004,517.25,579.5,367.75,70.60212515
WHEAT-HRW - CHICAGO BOARD OF TRADE,12/11/2018,001612,290910,53599,113629,46317,5223,9432,79332,78590,45578,22746,10012,8177,265181,270641,25729,20269,-60030,4247,-130381,52.25584574,41094,47122,19250,78.37256028,742,72845,-34476,32.81557198,22832,24304,-17805,96.50431024,477.25,579.5,367.75,51.71192444
WHEAT-HRW - CHICAGO BOARD OF TRADE,12/4/2018,001612,283969,54612,109695,46212,5211,7639,74599,78782,42897,23046,8975,9076,258081,262275,25888,21694,-55083,4943,-130381,55.64275369,41001,47122,19250,78.03889208,-4183,72845,-34476,28.22653535,19851,24304,-17805,89.42506353,483.75,579.5,367.75,54.78158205
WHEAT-HRW - CHICAGO BOARD OF TRADE,11/27/2018,001612,300600,67956,114676,44440,5811,9165,71768,82516,46020,24678,9265,9168,273195,276621,27405,23979,-46720,6050,-130381,61.32110737,38629,47122,19250,69.52855913,-10748,72845,-34476,22.10937282,21342,24304,-17805,92.96587428,458.5,579.5,367.75,42.85714286
WHEAT-HRW - CHICAGO BOARD OF TRADE,11/20/2018,001612,313728,70945,126730,44893,5562,12859,66715,74585,48278,31313,9183,10346,285349,287543,28379,26185,-55785,6050,-130381,54.67672303,39331,47122,19250,72.04721584,-7870,72845,-34476,24.79104742,16965,24304,-17805,82.57142179,473,579.5,367.75,49.70484061
WHEAT-HRW - CHICAGO BOARD OF TRADE,11/13/2018,001612,329717,84660,141282,44762,7840,13668,64603,69052,50643,31029,8925,12244,301609,303654,28108,26063,-56622,6050,-130381,54.0632261,36922,47122,19250,63.40413318,-4449,72845,-34476,27.97868078,19614,24304,-17805,88.86223848,486.5,579.5,367.75,56.08028335
WHEAT-HRW - CHICAGO BOARD OF TRADE,11/6/2018,001612,335619,86206,148510,42176,8202,12008,69202,62236,53690,30779,9500,15315,309376,309461,26243,26158,-62304,6050,-130381,49.89848348,33974,47122,19250,52.8272101,6966,72845,-34476,38.61499613,22911,24304,-17805,96.69191859,508,579.5,367.75,66.23376623
WHEAT-HRW - CHICAGO BOARD OF TRADE,10/30/2018,001612,325736,79782,140485,42123,8228,11898,70076,63353,53794,29588,10552,11387,298648,299697,27088,26039,-60703,6050,-130381,51.07197045,33895,47122,19250,52.54377153,6723,72845,-34476,38.3885726,24206,24304,-17805,99.76727065,494.75,579.5,367.75,59.97638725
WHEAT-HRW - CHICAGO BOARD OF TRADE,10/23/2018,001612,301551,67912,137095,40589,8449,11063,66864,49758,47687,29286,9513,13066,276467,276631,25084,24920,-69183,6050,-130381,44.85637428,32140,47122,19250,46.24712974,17106,72845,-34476,48.06328678,18401,24304,-17805,85.98161913,507.5,579.5,367.75,65.99763872
WHEAT-HRW - CHICAGO BOARD OF TRADE,10/16/2018,001612,293107,59870,135799,42338,8448,9200,66618,44327,48381,28767,9901,13515,268689,269571,24418,23536,-75929,6050,-130381,39.91175026,33890,47122,19250,52.52583238,22291,72845,-34476,52.89458727,19614,24304,-17805,88.86223848,528,579.5,367.75,75.67886659
WHEAT-HRW - CHICAGO BOARD OF TRADE,10/9/2018,001612,283454,58653,134342,42688,7942,7125,64770,44498,44235,30157,10195,11679,259307,260016,24147,23438,-75689,6050,-130381,40.08766336,34746,47122,19250,55.59701493,20272,72845,-34476,51.01331519,14078,24304,-17805,75.71540526,519.5,579.5,367.75,71.66469894
WHEAT-HRW - CHICAGO BOARD OF TRADE,10/2/2018,001612,279999,60577,134822,41782,9663,8694,66144,43293,37419,29964,10344,12200,256780,256435,23219,23564,-74245,6050,-130381,41.14607384,32119,47122,19250,46.1717853,22851,72845,-34476,53.41638635,7455,24304,-17805,59.98717614,522.5,579.5,367.75,73.08146399
WHEAT-HRW - CHICAGO BOARD OF TRADE,9/25/2018,001612,270040,53910,131431,40440,7190,10419,65840,37164,36158,27930,10521,12161,246858,245044,23182,24996,-77521,6050,-130381,38.74486004,33250,47122,19250,50.22962113,28676,72845,-34476,58.84402866,8228,24304,-17805,61.82288822,522,579.5,367.75,72.84533648
WHEAT-HRW - CHICAGO BOARD OF TRADE,9/18/2018,001612,272070,53708,134050,41553,7769,12056,66792,34255,35949,26782,11111,12693,249533,247883,22537,24187,-80342,6050,-130381,36.67714816,33784,47122,19250,52.14552239,32537,72845,-34476,62.44164702,9167,24304,-17805,64.05281531,516,579.5,367.75,70.01180638
WHEAT-HRW - CHICAGO BOARD OF TRADE,9/11/2018,001612,263307,48744,137484,44470,8343,12125,66028,25843,32848,25088,11047,11421,240724,239111,22583,24196,-88740,6050,-130381,30.52165564,36127,47122,19250,60.55180827,40185,72845,-34476,69.56793172,7760,24304,-17805,60.71148686,494.25,579.5,367.75,59.74025974
WHEAT-HRW - CHICAGO BOARD OF TRADE,9/4/2018,001612,253546,46006,146455,44239,6963,12559,70424,17846,24436,23713,11765,9882,231259,229906,22287,23640,-100449,6050,-130381,21.93929532,37276,47122,19250,64.67422503,52578,72845,-34476,81.11553191,723,24304,-17805,44.00009499,508,579.5,367.75,66.23376623
WHEAT-HRW - CHICAGO BOARD OF TRADE,8/28/2018,001612,263082,46305,153950,46477,5822,10632,75270,15122,27190,21578,13011,12341,239793,238068,23289,25014,-107645,6050,-130381,16.66483424,40655,47122,19250,76.79750287,60148,72845,-34476,88.16913745,5612,24304,-17805,55.61043957,499.25,579.5,367.75,62.10153483
WHEAT-HRW - CHICAGO BOARD OF TRADE,8/21/2018,001612,286830,54850,167383,47673,4238,11872,84818,21454,31444,20494,14527,11236,262387,262154,24443,24676,-112533,6050,-130381,13.08207079,43435,47122,19250,86.77167049,63364,72845,-34476,91.16575507,10950,24304,-17805,68.28706452,534.5,579.5,367.75,78.7485242
WHEAT-HRW - CHICAGO BOARD OF TRADE,8/14/2018,001612,281801,56867,166647,47243,3594,9519,83694,22273,27898,20440,14231,13314,258975,257476,22826,24325,-109780,6050,-130381,15.09994063,43649,47122,19250,87.53946613,61421,72845,-34476,89.35529859,7458,24304,-17805,59.99430051,545.75,579.5,367.75,84.06139315
WHEAT-HRW - CHICAGO BOARD OF TRADE,8/7/2018,001612,285855,58827,161806,46307,3422,12208,76617,22885,30069,20267,14226,18051,262346,262667,23509,23188,-102979,6050,-130381,20.08487807,42885,47122,19250,84.79836395,53732,72845,-34476,82.19081075,9802,24304,-17805,65.56080648,579.5,579.5,367.75,100
WHEAT-HRW - CHICAGO BOARD OF TRADE,7/31/2018,001612,284058,62236,153198,45986,2999,12001,67784,29803,29701,24050,12493,21904,263662,262099,20396,21959,-90962,6050,-130381,28.89299353,42987,47122,19250,85.16432262,37981,72845,-34476,67.51427959,5651,24304,-17805,55.70305635,556.5,556.5,367.75,100
WHEAT-HRW - CHICAGO BOARD OF TRADE,7/24/2018,001612,280721,64259,138402,45046,2475,9572,64139,44317,35278,24986,9086,17847,261127,256977,19594,23744,-74143,6050,-130381,41.22083691,42571,47122,19250,83.6717853,19822,72845,-34476,50.59401236,10292,24304,-17805,66.7244532,509.75,556.5,367.75,75.23178808
WHEAT-HRW - CHICAGO BOARD OF TRADE,7/17/2018,001612,274418,61524,122873,41625,8581,11920,63090,46816,36089,25030,8958,15781,255059,251018,19359,23400,-61349,6050,-130381,50.59847102,33044,47122,19250,49.49052813,16274,72845,-34476,47.28804241,11059,24304,-17805,68.54591655,490.75,556.5,367.75,65.16556291
WHEAT-HRW - CHICAGO BOARD OF TRADE,7/10/2018,001612,266347,59924,121078,41272,8627,11178,61563,43158,33735,24642,8797,14563,246877,241136,19470,25211,-61154,6050,-130381,50.74140041,32645,47122,19250,48.05898393,18405,72845,-34476,49.2736743,9093,24304,-17805,63.87708091,483.75,556.5,367.75,61.45695364
WHEAT-HRW - CHICAGO BOARD OF TRADE,7/3/2018,001612,254656,52639,111963,39754,8327,12558,60602,43900,30275,23634,8212,13955,233417,229190,21239,25466,-59324,6050,-130381,52.08273779,31427,47122,19250,43.68900689,16702,72845,-34476,47.686846,6641,24304,-17805,58.0540977,462.25,570.75,367.75,46.55172414
WHEAT-HRW - CHICAGO BOARD OF TRADE,6/26/2018,001612,249919,51348,127051,40426,2759,11203,65017,34425,24844,22203,8131,15393,230434,223806,19485,26113,-75703,6050,-130381,40.07740176,37667,47122,19250,66.07706659,30592,72845,-34476,60.62932697,2641,24304,-17805,48.55494075,458,593.25,367.75,40.02217295
WHEAT-HRW - CHICAGO BOARD OF TRADE,6/19/2018,001612,271951,52843,140604,42991,11128,13083,67591,20721,36286,24996,9701,14194,251984,245717,19967,26234,-87761,6050,-130381,31.23923448,31863,47122,19250,45.2533008,46870,72845,-34476,75.79690834,11290,24304,-17805,69.09449286,483,593.25,367.75,51.10864745
WHEAT-HRW - CHICAGO BOARD OF TRADE,6/12/2018,001612,293320,49955,155228,41806,10769,12826,75665,15059,41158,25124,9259,23895,270429,268194,22891,25126,-105273,6050,-130381,18.40344203,31037,47122,19250,42.28975316,60606,72845,-34476,88.59589456,16034,24304,-17805,80.36049301,553.5,593.25,367.75,82.37250554
WHEAT-HRW - CHICAGO BOARD OF TRADE,6/5/2018,001612,307909,48672,147748,40430,10611,22933,74606,17439,50084,25780,9752,23558,286063,282125,21846,25784,-99076,6050,-130381,22.94566484,29819,47122,19250,37.91977612,57167,72845,-34476,85.39148908,24304,24304,-17805,100,529,593.25,367.75,71.50776053
WHEAT-HRW - CHICAGO BOARD OF TRADE,5/29/2018,001612,291955,49604,148525,42292,5715,20680,68633,15025,41011,26350,13977,21972,270542,266905,21413,25050,-98921,6050,-130381,23.05927538,36577,47122,19250,62.1663318,53608,72845,-34476,82.07526952,14661,14661,-17805,100,556.5,593.25,367.75,83.70288248
WHEAT-HRW - CHICAGO BOARD OF TRADE,5/22/2018,001612,268541,47242,139013,40824,5650,13806,65128,19199,31972,25986,12919,21792,246750,244351,21791,24190,-91771,6050,-130381,28.30001979,35174,47122,19250,57.1326062,45929,72845,-34476,74.92009951,5986,11965,-17805,79.91602284,540.5,593.25,367.75,76.6075388
WHEAT-HRW - CHICAGO BOARD OF TRADE,5/15/2018,001612,262603,43914,131103,39541,5622,13616,64812,21179,31316,25484,12758,22970,241653,238564,20950,24039,-87189,6050,-130381,31.65849404,33919,47122,19250,52.62987945,43633,72845,-34476,72.78072325,5832,11965,-17805,79.39872355,509.75,593.25,367.75,62.97117517
WHEAT-HRW - CHICAGO BOARD OF TRADE,5/8/2018,001612,259419,39514,133149,42516,5943,9492,69575,21710,33162,25128,13113,19471,238858,236040,20561,23379,-93635,6050,-130381,26.93376139,36573,47122,19250,62.15198048,47865,72845,-34476,76.72403351,8034,11965,-17805,86.79543164,518.5,593.25,367.75,66.85144124
WHEAT-HRW - CHICAGO BOARD OF TRADE,5/1/2018,001612,249830,38616,129497,43413,1870,8204,62950,24290,30393,25551,12553,20380,229507,227187,20323,22643,-90881,6050,-130381,28.9523642,41543,47122,19250,79.98349598,38660,72845,-34476,68.14696099,4842,11965,-17805,76.07322808,532.25,593.25,367.75,72.94900222
WHEAT-HRW - CHICAGO BOARD OF TRADE,4/24/2018,001612,260998,44394,130091,40198,4066,11234,63950,23910,33304,25119,10906,21295,239494,234806,21504,26192,-85697,6050,-130381,32.75208714,36132,47122,19250,60.56974742,40040,72845,-34476,69.43282303,8185,11965,-17805,87.30265368,492.5,593.25,367.75,55.32150776
WHEAT-HRW - CHICAGO BOARD OF TRADE,4/17/2018,001612,269351,51060,129608,36577,4006,16259,59808,24507,34210,27422,13836,22615,247951,245041,21400,24310,-78548,6050,-130381,37.99209857,32571,47122,19250,47.7934845,35301,72845,-34476,65.01709824,6788,11965,-17805,82.61001008,480.5,593.25,367.75,50
WHEAT-HRW - CHICAGO BOARD OF TRADE,4/10/2018,001612,272176,54549,134427,38266,4306,15487,53569,21283,35597,28105,12638,23174,248747,246912,23429,25264,-79878,6050,-130381,37.01724681,33960,47122,19250,52.77698048,32286,72845,-34476,62.20776922,7492,11965,-17805,84.97480685,521.75,593.25,367.75,68.29268293
WHEAT-HRW - CHICAGO BOARD OF TRADE,4/3/2018,001612,290554,63826,129459,35829,8167,22384,50796,30820,37000,32313,12461,25722,267870,266013,22684,24541,-65633,6050,-130381,47.45842221,27662,47122,19250,30.18082664,19976,72845,-34476,50.7375071,4687,11965,-17805,75.5525697,484.75,593.25,367.75,51.88470067
WHEAT-HRW - CHICAGO BOARD OF TRADE,3/27/2018,001612,280634,59070,130362,36809,5680,20813,51846,26334,32050,31466,13839,26470,258524,255548,22110,25086,-71292,6050,-130381,43.31053793,31129,47122,19250,42.61983352,25512,72845,-34476,55.89586381,584,11965,-17805,61.7702385,464,593.25,367.75,42.68292683
WHEAT-HRW - CHICAGO BOARD OF TRADE,3/20/2018,001612,271630,55779,134228,39828,6056,16487,51193,23224,29492,32217,10689,25322,250318,245498,21312,26132,-78449,6050,-130381,38.06466272,33772,47122,19250,52.10246843,27969,72845,-34476,58.18525731,-2725,11965,-17805,50.65502183,470,593.25,367.75,45.34368071
WHEAT-HRW - CHICAGO BOARD OF TRADE,3/13/2018,001612,291335,56463,141066,44644,5602,13039,55434,28376,34023,35435,12945,30547,269585,265598,21750,25737,-84603,6050,-130381,33.55395768,39042,47122,19250,71.01033295,27058,72845,-34476,57.33640201,-1412,11965,-17805,55.06550218,507,593.25,367.75,61.75166297
WHEAT-HRW - CHICAGO BOARD OF TRADE,3/6/2018,001612,300111,64004,147997,44479,1916,13533,55684,36283,33964,36932,12537,28899,277495,275129,22616,24982,-83993,6050,-130381,34.00107014,42563,47122,19250,83.64308266,19401,72845,-34476,50.20173125,-2968,11965,-17805,49.83876386,529.25,593.25,367.75,71.61862528
WHEAT-HRW - CHICAGO BOARD OF TRADE,2/27/2018,001612,301350,63280,140534,48978,1856,11688,60232,51007,31590,33533,11434,29246,278547,277355,22803,23995,-77254,6050,-130381,38.94056336,47122,47122,19250,100,9225,72845,-34476,40.71989639,-1943,11965,-17805,53.28182734,489,593.25,367.75,53.76940133
WHEAT-HRW - CHICAGO BOARD OF TRADE,2/20/2018,001612,306651,70080,145404,44116,1652,15045,59726,47893,29811,34272,12610,29320,282370,281735,24281,24916,-75324,6050,-130381,40.35519787,42464,42627,19250,99.30273346,11833,72845,-34476,43.14998928,-4461,11965,-17805,44.82364797,471.75,593.25,367.75,46.11973392
WHEAT-HRW - CHICAGO BOARD OF TRADE,2/13/2018,001612,309170,68125,146970,44026,1629,16653,60508,47020,30581,33535,11643,29743,283171,284239,25999,24931,-78845,6050,-130381,37.77440611,42397,42627,19250,99.01612696,13488,72845,-34476,44.69209195,-2954,11965,-17805,49.88579106,474.5,593.25,367.75,47.33924612
WHEAT-HRW - CHICAGO BOARD OF TRADE,2/6/2018,001612,309542,71565,150940,43774,1147,12813,70079,56519,30386,33353,9661,24247,286217,285713,23325,23829,-79375,6050,-130381,37.38593135,42627,42627,19250,100,13560,72845,-34476,44.7591804,-2967,11965,-17805,49.84212294,469,593.25,367.75,44.90022173
WHEAT-HRW - CHICAGO BOARD OF TRADE,1/30/2018,001612,325892,75743,135908,43870,1742,11220,73116,79700,36598,37093,14576,23549,301189,303293,24703,22599,-60165,6050,-130381,51.46630898,42128,42128,19250,100,-6584,72845,-34476,25.98932175,-495,11965,-17805,58.14578435,469.75,593.25,367.75,45.23281596
WHEAT-HRW - CHICAGO BOARD OF TRADE,1/23/2018,001612,341290,82755,129041,43159,1673,9240,81774,99424,43019,31054,12366,23668,314669,318431,26621,22859,-46286,6050,-130381,61.63921689,41486,41486,19250,100,-17650,72845,-34476,15.67819905,11965,11965,-17805,100,423.25,593.25,367.75,24.61197339
WHEAT-HRW - CHICAGO BOARD OF TRADE,1/16/2018,001612,322287,80612,129751,41265,1632,9734,80650,94668,35101,30656,10508,19119,297137,300513,25150,21774,-49139,6050,-130381,59.54804993,39633,39853,19250,98.93219434,-14018,72845,-34476,19.06243885,4445,10899,-17805,77.51532887,422,593.25,367.75,24.05764967
WHEAT-HRW - CHICAGO BOARD OF TRADE,1/9/2018,001612,322317,82861,126102,40176,1471,8840,81780,101609,37184,32058,10582,14937,297836,300725,24481,21592,-43241,6050,-130381,63.87111434,38705,39853,19250,94.42799592,-19829,72845,-34476,13.64784152,5126,10899,-17805,79.88782051,439,593.25,367.75,31.59645233
WHEAT-HRW - CHICAGO BOARD OF TRADE,1/2/2018,001612,330410,92999,126453,35017,1634,15430,82369,112296,29491,33827,9262,15260,304393,309826,26017,20584,-33454,6050,-130381,71.04470392,33383,39853,19250,68.59680629,-29927,72845,-34476,4.238685812,-4336,10899,-17805,46.92377369,434.75,631.25,367.75,25.42694497
WHEAT-HRW - CHICAGO BOARD OF TRADE,12/26/2017,001612,329925,96196,123899,35157,1481,15529,79937,114413,29677,32770,8270,15837,305103,309106,24822,20819,-27703,6050,-130381,75.26002155,33676,39853,19250,70.01892928,-34476,72845,-34476,0,-3093,10899,-17805,51.2541806,420,636,367.75,19.47809879
WHEAT-HRW - CHICAGO BOARD OF TRADE,12/19/2017,001612,330044,98378,124077,34399,1493,13535,80031,111208,33361,29669,8584,15429,304802,307687,25242,22357,-25699,6050,-130381,76.72889593,32906,39853,19250,66.28160947,-31177,72845,-31481,0.291394283,3692,10899,-17805,74.89200111,420,664.75,367.75,17.59259259
WHEAT-HRW - CHICAGO BOARD OF TRADE,12/12/2017,001612,325199,99245,124829,37647,1462,8107,79317,110798,34007,26826,8530,15684,300833,303417,24366,21782,-25584,6050,-130381,76.81318762,36185,39853,19250,82.19676746,-31481,72845,-31481,0,7181,10899,-17805,87.04710145,394,664.75,367.75,8.838383838
WHEAT-HRW - CHICAGO BOARD OF TRADE,12/5/2017,001612,312714,93698,126917,37806,1455,8836,80369,101797,30123,25125,9085,13077,289034,291290,23680,21424,-33219,6050,-130381,71.21695216,36351,39853,19250,83.00247537,-21428,72845,-30005,8.33932912,4998,10899,-17805,79.44188963,414.25,664.75,367.75,15.65656566
WHEAT-HRW - CHICAGO BOARD OF TRADE,11/28/2017,001612,314879,95132,125869,40946,1389,6739,77310,101750,29143,24440,10116,16599,290309,291605,24570,23274,-30737,6050,-130381,73.03618679,39557,39853,19250,98.56331602,-24440,72845,-30005,5.410792416,4703,10899,-17805,78.41415831,409.25,664.75,367.75,13.97306397
WHEAT-HRW - CHICAGO BOARD OF TRADE,11/21/2017,001612,318493,94884,129043,39286,1906,8334,74629,95487,29631,27391,11143,18862,293017,294406,25476,24087,-34159,6050,-130381,70.52795919,37380,39853,19250,87.99689366,-20858,72845,-30005,8.893534273,2240,10899,-17805,69.83347269,420.25,664.75,367.75,17.67676768
WHEAT-HRW - CHICAGO BOARD OF TRADE,11/14/2017,001612,317282,93942,134474,38521,1935,6515,78937,89481,32325,25464,10373,18089,293793,293192,23489,24090,-40532,6050,-130381,65.85673344,36586,39853,19250,84.14308596,-10544,72845,-30005,18.92173068,6861,10899,-17805,85.93227425,428,664.75,367.75,20.28619529
WHEAT-HRW - CHICAGO BOARD OF TRADE,11/7/2017,001612,331038,95885,124721,37825,1864,8339,76011,99558,37982,27083,9184,20143,303268,301791,27770,29247,-28836,6050,-130381,74.42956513,35961,39853,19250,81.10954715,-23547,72845,-30005,6.279047156,10899,10899,-17805,100,426.5,664.75,367.75,19.78114478
WHEAT-HRW - CHICAGO BOARD OF TRADE,10/31/2017,001612,321518,95841,125643,37606,1953,10875,73300,94716,35196,27056,9970,17650,297524,296003,23994,25515,-29802,6050,-130381,73.7215149,35653,39853,19250,79.61461923,-21416,72845,-30005,8.350996597,8140,8140,-17805,100,416.5,664.75,367.75,16.41414141
WHEAT-HRW - CHICAGO BOARD OF TRADE,10/24/2017,001612,302974,87303,121181,38162,9105,8280,74971,85826,30402,25823,10197,13849,278790,278840,24184,24134,-33878,6050,-130381,70.73392411,29057,39853,19250,47.5998641,-10855,72845,-30005,18.61934857,4579,7010,-17805,90.20350594,434,664.75,367.75,22.30639731
WHEAT-HRW - CHICAGO BOARD OF TRADE,10/17/2017,001612,292525,79565,117071,38599,9025,10492,75317,80090,27271,24091,9145,14489,269824,267583,22701,24942,-37506,6050,-130381,68.07470443,29574,39853,19250,50.1092074,-4773,72845,-30005,24.53281478,3180,7010,-17805,84.56578682,433.25,664.75,367.75,22.05387205
WHEAT-HRW - CHICAGO BOARD OF TRADE,10/10/2017,001612,282344,76084,120362,38697,8631,10770,73140,72888,22337,23838,8276,13724,258590,256988,23754,25356,-44278,6050,-130381,63.11102315,30066,39853,19250,52.49720914,252,72845,-30005,29.41857073,-1501,7010,-17805,65.70219625,431.25,664.75,367.75,21.38047138
WHEAT-HRW - CHICAGO BOARD OF TRADE,10/3/2017,001612,272278,70652,122132,38926,10566,10418,73359,64415,20213,24157,8613,11380,249105,247737,23173,24541,-51480,6050,-130381,57.83216424,28360,39853,19250,44.21686162,8944,72845,-30005,37.86971317,-3944,7010,-17805,55.85734435,441.75,664.75,367.75,24.91582492
WHEAT-HRW - CHICAGO BOARD OF TRADE,9/26/2017,001612,268692,66593,128479,38114,3776,10176,77114,65963,18051,24656,8512,10555,245259,245512,23433,23180,-61886,6050,-130381,50.20486546,34338,39853,19250,73.23205358,11151,72845,-30005,40.01555664,-6605,7010,-17805,45.13399154,452.25,664.75,367.75,28.45117845
WHEAT-HRW - CHICAGO BOARD OF TRADE,9/19/2017,001612,272848,66453,127416,35881,3782,10858,80474,68444,21165,25600,8748,9675,250106,250088,22742,22760,-60963,6050,-130381,50.88139792,32099,39853,19250,62.36470417,12030,72845,-30005,40.87019932,-4435,7010,-17805,53.8787024,442,664.75,367.75,25
WHEAT-HRW - CHICAGO BOARD OF TRADE,9/12/2017,001612,273444,65907,122411,34210,7899,10338,81950,69307,22345,26079,8681,8541,249370,249522,24074,23922,-56504,6050,-130381,54.14971671,26311,39853,19250,34.271708,12643,72845,-30005,41.46621293,-3734,7010,-17805,56.70360669,416,664.75,367.75,16.24579125
WHEAT-HRW - CHICAGO BOARD OF TRADE,9/5/2017,001612,272800,64239,121408,33024,8270,11637,82499,67892,21041,26405,8606,10429,249274,249283,23526,23517,-57169,6050,-130381,53.66229083,24754,39853,19250,26.71455613,14607,72845,-30005,43.37578999,-5364,7010,-17805,50.13499899,419.5,664.75,367.75,17.42424242
WHEAT-HRW - CHICAGO BOARD OF TRADE,8/29/2017,001612,276595,63452,121922,32012,8127,10654,80356,62840,21427,26889,9374,16556,251346,250900,25249,25695,-58470,6050,-130381,52.70869524,23885,39853,19250,22.49672378,17516,72845,-30005,46.20418085,-5462,7010,-17805,49.74007657,397.25,664.75,367.75,9.932659933
WHEAT-HRW - CHICAGO BOARD OF TRADE,8/22/2017,001612,288214,64781,134812,30133,6128,10740,76278,52944,28326,35703,10866,17373,263334,261189,24880,27025,-70031,6050,-130381,44.23481467,24005,39853,19250,23.07916323,23334,72845,-30005,51.86096257,-7377,7010,-17805,42.02296998,399,664.75,367.75,10.52188552
WHEAT-HRW - CHICAGO BOARD OF TRADE,8/15/2017,001612,265006,52707,144300,36680,3602,4788,71980,37486,23553,37650,10669,13747,241105,238145,23901,26861,-91593,6050,-130381,28.43048867,33078,39853,19250,67.11643935,34494,72845,-30005,62.71171609,-14097,7010,-17805,14.94257506,426.5,664.75,367.75,19.78114478
WHEAT-HRW - CHICAGO BOARD OF TRADE,8/8/2017,001612,268862,49250,156339,37904,3685,9362,73955,25262,22723,36464,9412,14506,244164,241289,24698,27573,-107089,6050,-130381,17.07236625,34219,39853,19250,72.6544678,48693,72845,-30005,76.51725814,-13741,7010,-17805,16.37719121,460.5,664.75,367.75,31.22895623
WHEAT-HRW - CHICAGO BOARD OF TRADE,8/1/2017,001612,273389,48497,151855,39631,3954,15559,74505,20416,19670,35841,20375,16542,250245,248371,23144,25018,-103358,6050,-130381,19.80708197,35677,39853,19250,79.73110712,54089,72845,-30005,81.76373359,-16171,7010,-17805,6.58472698,465.25,664.75,367.75,32.82828283
WHEAT-HRW - CHICAGO BOARD OF TRADE,7/25/2017,001612,262690,41146,164461,42950,4429,7327,76260,15711,21835,34327,11881,14714,238559,240358,24131,22332,-123315,6050,-130381,5.179174821,38521,39853,19250,93.5349221,60549,72845,-30005,88.04472533,-12492,7010,-17805,21.41043724,472.75,664.75,367.75,35.35353535
WHEAT-HRW - CHICAGO BOARD OF TRADE,7/18/2017,001612,266453,40409,170790,44142,4289,6931,82509,11758,24939,32616,13257,11118,242664,243082,23789,23371,-130381,6050,-130381,0,39853,39853,19250,100,70751,72845,-30005,97.96402528,-7677,7010,-17805,40.81402378,502.75,664.75,367.75,45.45454545
WHEAT-HRW - CHICAGO BOARD OF TRADE,7/11/2017,001612,269659,42908,172992,41791,4527,7982,82906,10061,27008,33550,12553,10939,247084,246062,22575,23597,-130084,6050,-130084,0,37264,38443,19250,93.85713541,72845,72845,-30005,100,-6542,7010,-17805,45.38787024,541,664.75,367.75,58.33333333
WHEAT-HRW - CHICAGO BOARD OF TRADE,7/3/2017,001612,261240,44162,156989,41920,3477,7995,75136,20562,26385,31927,10215,11553,239078,237176,22162,24064,-112827,6050,-112827,0,38443,38443,19250,100,54574,54574,-30005,100,-5542,7010,-17805,49.41769091,541.25,675,367.75,56.46867372
WHEAT-HRW - CHICAGO BOARD OF TRADE,6/27/2017,001612,262793,45775,144752,38564,2310,10688,76885,32761,25708,29782,7822,14591,241993,238632,20800,24161,-98977,6050,-98977,0,36254,37803,19250,91.65094594,44124,44124,-30005,100,-4074,7010,-17805,55.33346766,457.25,700,367.75,26.93754703
WHEAT-HRW - CHICAGO BOARD OF TRADE,6/20/2017,001612,275255,52229,140983,35682,1620,14263,74201,41236,27599,34992,8046,13584,252550,247331,22705,27924,-88754,6050,-88754,0,34062,37803,19250,79.8361451,32965,37667,-30005,93.05177917,-7393,7010,-17805,41.95849285,474.25,705.5,367.75,31.53219837
WHEAT-HRW - CHICAGO BOARD OF TRADE,6/13/2017,001612,282447,54818,128466,39256,1560,11781,86146,64704,27836,23480,7136,15666,258983,257149,23464,25298,-73648,6050,-82307,9.800015845,37696,37803,19250,99.42327386,21442,37667,-30005,76.02405722,4356,7010,-17805,89.30485593,457,712.5,367.75,25.88832487
WHEAT-HRW - CHICAGO BOARD OF TRADE,6/6/2017,001612,286200,64957,120343,37388,1688,7967,79372,78501,24777,25606,7656,21078,261145,262010,25055,24190,-55386,6050,-82307,30.46844053,35700,37803,19250,88.66490595,871,37667,-30005,45.62596052,-829,7010,-17805,68.41023574,438,726,367.75,19.60921144
WHEAT-HRW - CHICAGO BOARD OF TRADE,5/30/2017,001612,275577,64491,118351,37299,1474,6523,74107,72126,21748,22667,7977,23286,250121,251485,25456,24092,-53860,6050,-82307,32.19552497,35825,37803,19250,89.33865143,1981,37667,-30005,47.26622532,-919,7010,-17805,68.04755188,433.25,726,367.75,18.2833217
WHEAT-HRW - CHICAGO BOARD OF TRADE,5/23/2017,001612,266320,63554,118169,38136,1351,5320,74024,72338,16497,22979,7957,21322,241832,242954,24488,23366,-54615,6050,-82307,31.34103693,36785,37803,19250,94.51301676,1686,37667,-30005,46.83029909,-6482,7010,-17805,45.62965948,430.5,738.25,367.75,16.9365722
WHEAT-HRW - CHICAGO BOARD OF TRADE,5/16/2017,001612,246509,60430,114241,36198,1375,3551,74104,72093,9788,24267,7736,14891,223229,223675,23280,22834,-53811,6050,-82307,32.25098181,34823,37803,19250,83.93790762,2011,37667,-30005,47.3105568,-14479,7010,-17805,13.40318356,424.5,768.25,367.75,14.16978777
WHEAT-HRW - CHICAGO BOARD OF TRADE,5/9/2017,001612,246763,54400,115365,37676,1380,3032,76312,63230,11060,22512,8515,20200,225192,222782,21571,23981,-60965,6050,-82307,24.15428319,36296,37803,19250,91.87732442,13082,37667,-30005,63.67035111,-11452,7010,-17805,25.60145074,427,824.25,367.75,12.97918949
WHEAT-HRW - CHICAGO BOARD OF TRADE,5/2/2017,001612,249823,53543,104312,38789,1230,3610,80745,80451,9697,21867,8235,20109,228360,227644,21463,22179,-50769,6050,-82307,35.69383297,37559,37803,19250,98.68484881,294,37667,-30005,44.77331836,-12170,7010,-17805,22.70803949,454.75,843,367.75,18.30615466
WHEAT-HRW - CHICAGO BOARD OF TRADE,4/25/2017,001612,278966,69761,96251,34450,7933,3950,85028,102644,14152,24865,9500,23417,255623,257847,23343,21119,-26490,6050,-82307,63.17213124,26517,37803,19250,39.16886757,-17616,37667,-30005,18.30742405,-10713,7010,-17805,28.57948821,412,843,367.75,9.310889006
WHEAT-HRW - CHICAGO BOARD OF TRADE,4/18/2017,001612,275698,73134,105290,31416,7075,6753,79765,94837,12869,30674,9135,17439,252050,253398,23648,22300,-32156,6050,-82307,56.75950972,24341,37803,19250,27.44030615,-15072,37667,-30005,22.06673366,-17805,7010,-17805,0,419.25,843,367.75,10.83640189
WHEAT-HRW - CHICAGO BOARD OF TRADE,4/11/2017,001612,271532,71301,104665,31695,7128,10228,80006,92015,11980,28695,8194,13884,247789,248094,23743,23438,-33364,6050,-82307,55.39232885,24567,37803,19250,28.65843799,-12009,37667,-30005,26.59297789,-16715,7010,-16753,0.159912469,429.75,843,367.75,13.04576539
WHEAT-HRW - CHICAGO BOARD OF TRADE,4/4/2017,001612,270062,71617,104023,31794,7415,10196,79109,86558,13497,24722,9217,14779,245714,245685,24348,24377,-32406,6050,-82307,56.47656666,24379,37803,19250,27.64512478,-7449,41664,-30005,31.47246369,-11225,7010,-16753,23.26305601,421.75,843,367.75,11.36244082
WHEAT-HRW - CHICAGO BOARD OF TRADE,3/28/2017,001612,245610,61374,101506,36479,7251,6490,67553,69143,14404,22878,9133,14712,223890,222639,21720,22971,-40132,6050,-82307,47.73249431,29228,37803,19250,53.78105967,-1590,45752,-30005,37.50808506,-8474,7010,-16753,34.83987712,424,843,367.75,11.83587585
WHEAT-HRW - CHICAGO BOARD OF TRADE,3/21/2017,001612,223589,49442,109613,38579,905,5217,64242,48934,15464,17903,8785,13065,203912,201983,19677,21606,-60171,6050,-82307,25.05291035,37674,37803,19250,99.30469466,15308,45752,-30005,59.81361458,-2439,7010,-16753,60.23650213,438.25,843,367.75,14.83429774
WHEAT-HRW - CHICAGO BOARD OF TRADE,3/14/2017,001612,215949,41454,110190,38751,948,6336,64430,39140,15085,16804,9265,13056,195916,194020,20033,21929,-68736,6050,-82307,15.3592811,37803,37803,19250,100,25290,45752,-30005,72.98995472,-1719,7010,-16753,63.26642259,433.25,843,367.75,13.78221988
WHEAT-HRW - CHICAGO BOARD OF TRADE,3/7/2017,001612,211872,35860,117848,38864,1112,3546,67518,32212,14432,18617,8899,12513,191350,190562,20522,21310,-81988,6050,-82307,0.361035345,37752,37752,19250,100,35306,45752,-30005,86.2111752,-4185,7010,-16753,52.888945,463.25,843,367.75,20.09468701
WHEAT-HRW - CHICAGO BOARD OF TRADE,2/28/2017,001612,206976,34765,117072,37797,753,3735,69699,32032,13005,19399,9036,8451,186851,184084,20125,22892,-82307,6050,-82307,0,37044,37414,19250,97.96300374,37667,45752,-30005,89.32771889,-6394,7010,-16753,43.59298068,451.25,843,367.75,17.56970016
WHEAT-HRW - CHICAGO BOARD OF TRADE,2/21/2017,001612,229651,45120,125656,37824,542,4845,68857,34284,14270,20738,11140,15607,207261,206344,22390,23307,-80536,6050,-80536,0,37282,37414,19250,99.27328782,34573,45752,-30005,85.24360785,-6468,7010,-16753,43.28157219,452.25,843,367.75,17.78011573
WHEAT-HRW - CHICAGO BOARD OF TRADE,2/14/2017,001612,229431,46587,121160,36669,586,4918,65511,37932,15459,21310,9365,15275,205729,204695,23702,24736,-74573,6050,-74573,0,36083,37414,19250,92.67231887,27579,45752,-30005,76.01145769,-5851,7010,-16753,45.8780457,465.25,843,367.75,20.51551815
WHEAT-HRW - CHICAGO BOARD OF TRADE,2/7/2017,001612,235143,45364,107282,33840,717,10760,67575,49888,16346,20597,8260,17805,212287,211058,22856,24085,-61918,6050,-67925,8.120310916,33123,37414,19250,76.37634882,17687,45752,-30005,62.95391845,-4251,7010,-16753,52.61120229,439.5,843,367.75,15.0973172
WHEAT-HRW - CHICAGO BOARD OF TRADE,1/31/2017,001612,233169,45575,104746,33270,725,11947,65323,47953,15997,19752,10018,18710,210574,210096,22595,23073,-59171,6050,-67925,11.83372761,32545,37414,19250,73.19423035,17370,45752,-30005,62.53547527,-3755,7010,-16753,54.69848083,429.5,843,367.75,12.99316149
WHEAT-HRW - CHICAGO BOARD OF TRADE,1/24/2017,001612,227668,41110,109035,32993,669,9911,68864,41314,16521,18964,9289,18236,206599,204975,21069,22693,-67925,6050,-67925,0,32324,37414,19250,71.97753799,27550,45752,-30005,75.9731774,-2443,7010,-16753,60.21966923,441.75,843,367.75,15.57075224
WHEAT-HRW - CHICAGO BOARD OF TRADE,1/17/2017,001612,232648,43213,110533,34643,669,9698,68447,41996,19356,19118,10548,17552,212027,210352,20621,22296,-67320,6050,-67320,0,33974,37414,19250,81.06144021,26451,45752,-30005,74.52248637,238,7010,-16753,71.50191474,452,843,367.75,17.72751184
WHEAT-HRW - CHICAGO BOARD OF TRADE,1/10/2017,001612,234182,49018,104797,30935,687,8646,70240,47028,21601,16804,12589,15705,212949,211053,21233,23129,-55779,6050,-57404,2.560910266,30248,37414,19250,60.54833737,23212,45752,-30005,70.24697388,4797,7010,-16753,90.68720279,438.25,843,367.75,14.83429774
WHEAT-HRW - CHICAGO BOARD OF TRADE,1/3/2017,001612,240665,54095,93892,27827,561,7598,72971,61856,23362,18353,17847,14259,218465,219375,22200,21290,-39797,6050,-57404,27.74765972,27266,37414,19250,44.13124862,11115,45752,-30005,54.27881252,5009,7010,-16753,91.57934604,414,843,367.75,9.731720147
WHEAT-HRW - CHICAGO BOARD OF TRADE,12/27/2016,001612,242328,55438,90758,27417,422,9066,74179,65441,22697,18589,19296,13637,221023,221317,21305,21011,-35320,6050,-57404,34.8031645,26995,37414,19250,42.6392865,8738,45752,-30005,51.14114867,4108,7010,-16753,87.78773724,418.75,843,367.75,10.73119411
WHEAT-HRW - CHICAGO BOARD OF TRADE,12/20/2016,001612,247476,60884,88638,26722,319,9027,74308,70757,22556,18809,20848,12818,225124,224963,22352,22513,-27754,6050,-57404,46.72676269,26403,37414,19250,39.38009249,3551,45752,-30005,44.29425664,3747,7010,-16753,86.26856878,412.75,843,367.75,9.468700684
WHEAT-HRW - CHICAGO BOARD OF TRADE,12/13/2016,001612,259126,67647,87071,25578,1703,8929,80002,80741,22803,18653,21950,12354,235966,235551,23160,23575,-19424,6050,-57404,59.8543827,23875,37414,19250,25.4624532,-739,45752,-30005,38.6314136,4150,7010,-16753,87.9644826,399.25,843,367.75,6.628090479
WHEAT-HRW - CHICAGO BOARD OF TRADE,12/6/2016,001612,255892,60876,89832,28675,1843,6080,79400,76293,21128,19246,18497,18739,234144,232412,21748,23480,-28956,6050,-57404,44.83247707,26832,37414,19250,41.74190707,3107,45752,-30005,43.70817218,1882,7010,-16753,78.42023314,387,843,367.75,4.050499737
WHEAT-HRW - CHICAGO BOARD OF TRADE,11/29/2016,001612,245249,53637,93915,29708,1955,5148,83638,66524,21960,15224,17030,14584,223899,221116,21350,24133,-40278,6050,-57404,26.98963028,27753,37414,19250,46.81237613,17114,45752,-30005,62.1975527,6736,7010,-16753,98.84694693,398.75,843,367.75,6.522882693
WHEAT-HRW - CHICAGO BOARD OF TRADE,11/22/2016,001612,265441,65575,100576,28551,2122,8386,82257,71371,24487,17477,19300,16043,242776,242285,22665,23156,-35001,6050,-57404,35.30589088,26429,37414,19250,39.52323277,10886,45752,-30005,53.97653022,7010,7010,-16753,100,416.5,843,367.75,10.25775907
WHEAT-HRW - CHICAGO BOARD OF TRADE,11/15/2016,001612,259745,64688,92206,27582,2086,9573,80202,78237,25279,19961,18647,10367,237652,236395,22093,23350,-27518,6050,-57404,47.09868566,25496,37414,19250,34.38669896,1965,45752,-30005,42.20072073,5318,6001,-16753,96.99832996,408,843,367.75,8.469226723
WHEAT-HRW - CHICAGO BOARD OF TRADE,11/8/2016,001612,266296,58627,90859,28068,2134,10611,79997,78519,23572,23374,17769,19650,243899,243114,22397,23182,-32232,6050,-57404,39.66968197,25934,37414,19250,36.7980621,1478,45752,-30005,41.55787584,198,6001,-16753,74.49679177,417.5,843,367.75,10.46817464
WHEAT-HRW - CHICAGO BOARD OF TRADE,11/1/2016,001612,263869,56823,93467,28485,1998,12568,75973,71955,21642,24357,17131,21792,241640,240553,22229,23316,-36644,6050,-65483,40.31565851,26487,37414,19250,39.84254569,4018,45752,-30005,44.91070132,-2715,6001,-16753,61.6946471,413.75,843,367.75,9.679116255
WHEAT-HRW - CHICAGO BOARD OF TRADE,10/25/2016,001612,255090,57054,94744,29899,2988,8255,75435,70063,19869,24279,16255,19825,234616,231999,20474,23091,-37690,6050,-70686,42.99937448,26911,37414,19250,42.1768333,5372,45752,-30005,46.6979949,-4410,6001,-16753,54.2454074,413.5,843,367.75,9.626512362
WHEAT-HRW - CHICAGO BOARD OF TRADE,10/18/2016,001612,250582,54853,91903,33193,2979,6995,75575,74712,16728,23915,16351,19133,230392,228801,20190,21781,-37050,6050,-70899,43.98887575,30214,37414,19250,60.36115393,863,45752,-30005,40.74606967,-7187,6001,-16753,42.04095983,421.75,843,367.75,11.36244082
WHEAT-HRW - CHICAGO BOARD OF TRADE,10/11/2016,001612,246225,59426,88275,32735,3013,4904,73880,79747,13424,25313,17353,16895,226577,223611,19648,22614,-28849,6050,-70899,54.6465841,29722,37414,19250,57.65249945,-5867,45752,-30005,31.86240215,-11889,6001,-16753,21.37646128,406.25,843,367.75,8.100999474
WHEAT-HRW - CHICAGO BOARD OF TRADE,10/4/2016,001612,239676,55226,88279,34729,3016,4549,72928,73783,12276,24615,18424,16015,220338,216342,19338,23334,-33053,6050,-70899,49.18322525,31713,37414,19250,68.61374147,-855,45752,-30005,38.47829244,-12339,6001,-16753,19.39878703,403,843,367.75,7.417148869
WHEAT-HRW - CHICAGO BOARD OF TRADE,9/27/2016,001612,233164,56757,89888,39591,5009,3124,63804,69300,11820,25194,18336,12418,212708,209895,20456,23269,-33131,6050,-70899,49.08185941,34582,37414,19250,84.40872055,-5496,45752,-30005,32.35212588,-13374,6001,-16753,14.85013624,419.25,843,367.75,10.83640189
WHEAT-HRW - CHICAGO BOARD OF TRADE,9/20/2016,001612,232429,60008,88001,39031,5006,3132,61573,70127,12106,24361,18432,12029,212240,208833,20189,23596,-27993,6050,-70899,55.75900921,34025,37414,19250,81.34221537,-8554,45752,-30005,28.3155352,-12255,6001,-16753,19.76795289,418.5,843,367.75,10.67859022
WHEAT-HRW - CHICAGO BOARD OF TRADE,9/13/2016,001612,231027,62021,85745,40061,5150,3377,56178,69534,11757,25031,19751,12398,210823,207712,20204,23315,-23724,6050,-70899,61.3068396,34911,37414,19250,86.2199956,-13356,45752,-30005,21.97684702,-13274,6001,-16753,15.28961941,392.25,843,367.75,5.155181483
WHEAT-HRW - CHICAGO BOARD OF TRADE,9/6/2016,001612,231473,61269,81940,38933,5163,3553,55515,72483,12300,26097,19997,13302,210969,208738,20504,22735,-20671,6050,-70899,65.27440253,33770,37414,19250,79.93833957,-16968,45752,-30005,17.20897079,-13797,6001,-16753,12.99112244,384,843,367.75,3.419253025
WHEAT-HRW - CHICAGO BOARD OF TRADE,8/30/2016,001612,227572,60706,79048,35743,4754,3858,54046,71201,13100,27004,20042,12705,207162,204708,20410,22864,-18342,6050,-70899,68.30108254,30989,37414,19250,64.62783528,-17155,45752,-30005,16.96212891,-13904,6001,-16753,12.52087545,367.75,843,367.75,0
WHEAT-HRW - CHICAGO BOARD OF TRADE,8/23/2016,001612,233774,64350,92593,34884,253,4333,50889,66437,15601,31681,20644,10572,212310,210433,21464,23341,-28243,6050,-70899,55.4341187,34631,37414,19250,84.67848492,-15548,45752,-30005,19.08338503,-16080,6001,-16753,2.957721719,407.25,843,402,1.19047619
WHEAT-HRW - CHICAGO BOARD OF TRADE,8/16/2016,001612,239572,72747,91798,34529,253,4313,43955,68701,17267,33035,20855,11324,217170,214511,22402,25061,-19051,6050,-70899,67.37969304,34276,37414,19250,82.72406959,-24746,45752,-30005,6.941932759,-15768,6001,-16753,4.328909203,411.25,843,402,2.097505669
WHEAT-HRW - CHICAGO BOARD OF TRADE,8/9/2016,001612,242243,74134,93161,34491,253,4452,42110,68571,18340,32990,20345,12845,219362,217967,22881,24276,-19027,6050,-70899,67.41088253,34238,37414,19250,82.51486457,-26461,45752,-30005,4.678115554,-14650,6001,-16753,9.242331019,410,843,402,1.814058957
WHEAT-HRW - CHICAGO BOARD OF TRADE,8/2/2016,001612,241221,69617,84092,31984,257,6606,40675,69547,19943,34784,20395,15591,219200,216431,22021,24790,-14475,6050,-70899,73.32648897,31727,37414,19250,68.690817,-28872,45752,-30005,1.495571366,-14841,6001,-16753,8.402918168,406.5,843,402,1.020408163
WHEAT-HRW - CHICAGO BOARD OF TRADE,7/26/2016,001612,242725,70032,82978,29927,1210,7970,42472,72477,21314,35193,19087,14138,221046,219174,21679,23551,-12946,6050,-70899,75.31351934,28717,37414,19250,52.11957719,-30005,45752,-30005,0,-13879,6001,-16753,12.63074624,412,843,402,2.267573696
WHEAT-HRW - CHICAGO BOARD OF TRADE,7/19/2016,001612,230596,67979,72308,26702,7335,6953,45267,65480,18424,33858,25870,10629,209812,206999,20784,23597,-4329,6050,-70899,86.51184551,19367,37414,19250,0.644131249,-20213,45752,-28091,10.66858064,-15434,6001,-16753,5.796782983,410.5,843,402,1.927437642
WHEAT-HRW - CHICAGO BOARD OF TRADE,7/12/2016,001612,225914,66616,69688,26436,7186,5248,47164,66355,16359,33112,25895,11983,206918,202714,18996,23200,-3072,6050,-70899,88.145395,19250,37414,19250,0,-19191,45752,-28091,12.05259808,-16753,6001,-16753,0,407.75,843,402,1.303854875
WHEAT-HRW - CHICAGO BOARD OF TRADE,7/5/2016,001612,222790,65412,69437,26741,7339,3549,49446,66736,15386,31015,25207,11370,202919,199024,19871,23766,-4025,6050,-70899,86.90691237,19402,37414,19402,0,-17290,45752,-28091,14.62697886,-15629,6001,-15629,0,402,843,402,0
WHEAT-HRW - CHICAGO BOARD OF TRADE,6/28/2016,001612,215643,61670,68934,29323,5187,3261,46846,61949,14540,29132,26426,11522,196294,191819,19349,23824,-7264,6050,-70899,82.6976309,24136,37414,24136,0,-15103,45752,-28091,17.58866785,-14592,6001,-15137,2.578295014,408.75,843,408.75,0
WHEAT-HRW - CHICAGO BOARD OF TRADE,6/21/2016,001612,226450,65203,86046,29482,1472,4866,49272,53737,16700,27811,25077,13207,206541,201105,19909,25345,-20843,6050,-70899,65.05087785,28010,37414,25622,20.25101764,-4465,45752,-28091,31.99490812,-11111,6001,-15137,19.04626739,435,843,435,0
WHEAT-HRW - CHICAGO BOARD OF TRADE,6/14/2016,001612,226906,66586,91081,28582,1131,5301,51123,49347,18375,24872,23509,13032,207871,201776,19035,25130,-24495,6050,-70899,60.30487726,27451,37414,25622,15.5105156,1776,45752,-28091,40.44662324,-6497,6001,-15137,40.8742549,458.5,843,436.75,5.353846154
WHEAT-HRW - CHICAGO BOARD OF TRADE,6/7/2016,001612,227192,70417,85822,28412,890,4921,45479,54906,17882,26569,25515,13294,206974,203230,20218,23962,-15405,6050,-70899,72.11789627,27522,39463,25622,13.72733184,-9427,45752,-28091,25.27524613,-8687,6001,-15137,30.51376668,485,843,436.75,11.87692308
WHEAT-HRW - CHICAGO BOARD OF TRADE,5/31/2016,001612,230273,70978,75902,28287,1097,6181,41379,61257,19432,28405,27586,15384,210046,206839,20227,23434,-4924,6050,-70899,85.73860609,27190,41347,25622,9.971383148,-19878,45752,-28091,11.12224585,-8973,6001,-15137,29.16075315,447.25,843,436.75,2.584615385
WHEAT-HRW - CHICAGO BOARD OF TRADE,5/24/2016,001612,227316,69437,74602,29107,928,6206,40368,59822,20947,28050,27683,13090,207205,203278,20111,24038,-5165,6050,-70899,85.42541164,28179,41868,25622,15.73925889,-19454,45752,-28091,11.69643704,-7103,6001,-15137,38.00738007,446.5,843,436.75,2.4
WHEAT-HRW - CHICAGO BOARD OF TRADE,5/17/2016,001612,225268,67225,78200,29322,758,5643,43127,58831,18643,28533,26812,13460,205953,202347,19315,22921,-10975,6050,-70899,77.87495614,28564,43082,25622,16.84994273,-15704,45752,-28091,16.77477892,-9890,6001,-15137,24.82259438,457.75,843,436.75,5.169230769
WHEAT-HRW - CHICAGO BOARD OF TRADE,5/10/2016,001612,215287,65308,78822,31145,1063,3911,41693,52665,17109,23760,25537,12761,195687,191868,19600,23419,-13514,6050,-70899,74.5753681,30082,43082,25622,25.5441008,-10972,45752,-28091,23.18296927,-6651,6001,-15137,40.14570915,436.75,843,436.75,0
WHEAT-HRW - CHICAGO BOARD OF TRADE,5/3/2016,001612,202441,58622,77809,31991,981,4391,41580,47361,13424,21693,23762,10808,182509,178536,19932,23905,-19187,6050,-70899,67.2029526,31010,43170,25622,30.70435377,-5781,45752,-28091,30.21274867,-8269,6001,-15137,32.49124799,442,843,437.5,1.10974106
WHEAT-HRW - CHICAGO BOARD OF TRADE,4/26/2016,001612,201352,60353,80515,30591,3370,4634,43715,44590,12021,20465,22597,10525,182304,178252,19048,23100,-20162,6050,-70899,65.93587961,27221,45228,25622,8.155666633,-875,45752,-28091,36.85657408,-8444,6001,-15137,31.6633551,466.25,843,437.5,7.09001233
WHEAT-HRW - CHICAGO BOARD OF TRADE,4/19/2016,001612,216918,67082,72857,31190,3152,5560,42777,56532,15136,21997,28465,12004,195746,193706,21172,23212,-5775,6050,-70899,84.63267879,28038,45228,25622,12.32275834,-13755,45752,-28091,19.41416248,-6861,6001,-15137,39.15223768,476.75,843,437.5,9.679408138
WHEAT-HRW - CHICAGO BOARD OF TRADE,4/12/2016,001612,214931,69020,69169,30029,2804,5436,36699,57164,16495,21820,28202,12478,191977,191748,22954,23183,-149,6050,-70899,91.94401487,27225,45228,25622,8.17606855,-20465,45752,-28091,10.32731606,-5325,6001,-15137,46.41877188,447.25,843,437.5,2.404438964
WHEAT-HRW - CHICAGO BOARD OF TRADE,4/5/2016,001612,210844,62697,72687,31675,2731,7626,35573,47235,16800,19354,25202,15298,189023,187579,21821,23265,-9990,6050,-70899,79.15502476,28944,45228,25622,16.94379272,-11662,45752,-28091,22.24855437,-2554,7494,-15137,55.60072467,473.5,843,437.5,8.877928483
WHEAT-HRW - CHICAGO BOARD OF TRADE,3/29/2016,001612,205432,58468,72979,35287,2205,5368,34122,46405,17518,20477,24490,13228,184468,182193,20964,23239,-14511,6050,-70899,73.27970474,33082,45228,25622,38.04957666,-12283,45752,-28091,21.40758095,-2959,7494,-15137,53.81114401,481.75,843,437.5,10.91245376
WHEAT-HRW - CHICAGO BOARD OF TRADE,3/22/2016,001612,203546,59057,75585,36053,0,5195,33225,44529,18154,20228,24300,11417,183329,179180,20217,24366,-16528,6050,-70899,70.65848809,36053,45228,25622,53.20310109,-11304,45752,-28091,22.73336674,-2074,7494,-15137,57.72170916,476.75,843,437.5,9.679408138
WHEAT-HRW - CHICAGO BOARD OF TRADE,3/15/2016,001612,198960,58367,73849,36063,0,5144,33944,49031,17510,20625,22304,7720,179373,175558,19587,23402,-15482,6050,-70899,72.01782999,36063,45228,25622,53.25410589,-15087,45752,-28091,17.61033544,-3115,7494,-15137,53.12182405,489,843,437.5,12.70036991
WHEAT-HRW - CHICAGO BOARD OF TRADE,3/8/2016,001612,210160,66531,69428,37414,0,4402,37809,63803,15334,22108,27585,6861,190459,187413,19701,22747,-2897,6050,-70899,88.37281836,37414,45228,25622,60.14485362,-25994,45752,-28091,2.839808784,-6774,7494,-15137,36.95373603,460.25,843,437.5,5.610357583
WHEAT-HRW - CHICAGO BOARD OF TRADE,3/1/2016,001612,215138,69008,66417,37004,0,4247,40211,68302,14452,22236,30233,8533,195691,192184,19447,22954,2591,6050,-70899,95.50481488,37004,45228,25622,58.05365704,-28091,45752,-28091,0,-7784,9120,-15137,30.31289937,437.5,843,437.5,0
WHEAT-HRW - CHICAGO BOARD OF TRADE,2/23/2016,001612,221923,75013,72025,36038,3,4756,38840,66202,14940,19875,28247,9898,199360,196071,22563,25852,2988,6050,-70899,96.02074101,36035,45228,25622,53.11129246,-27362,45752,-27362,0,-4935,10563,-15137,39.69649805,446.25,843,445,0.314070352
WHEAT-HRW - CHICAGO BOARD OF TRADE,2/16/2016,001612,220157,74810,70563,33515,0,5340,36992,60942,15395,18097,28169,12446,196595,192855,23562,27302,4247,6050,-70899,97.65688963,33515,45228,25622,40.25808426,-23950,45752,-26203,3.131123619,-2702,14133,-15137,42.48377178,450.75,843,445,1.444723618
WHEAT-HRW - CHICAGO BOARD OF TRADE,2/9/2016,001612,222982,69518,66752,33810,0,7965,34788,60991,17868,19129,27644,15216,198294,196436,24688,26546,2766,6050,-70899,95.73223824,33810,47440,25622,37.52864607,-26203,45752,-26203,0,-1261,15927,-15137,44.66907031,445,843,445,0
WHEAT-HRW - CHICAGO BOARD OF TRADE,2/2/2016,001612,219124,65553,68801,35306,0,10289,32850,52826,19798,18594,27881,15102,197492,194697,21632,24427,-3248,6050,-70899,87.91667208,35306,49647,25622,40.30801249,-19976,45752,-24100,5.903911126,1204,15927,-15137,52.6043008,465.25,843,451.5,3.512132822
WHEAT-HRW - CHICAGO BOARD OF TRADE,1/26/2016,001612,216083,65135,71364,33758,17,9425,32806,49313,20446,18349,26950,14345,194264,191860,21819,24223,-6229,6050,-70899,84.04267762,33741,49647,25622,33.79396462,-16507,45752,-24100,10.87012541,2097,15927,-15137,55.47901107,476.75,843,451.5,6.449553001
WHEAT-HRW - CHICAGO BOARD OF TRADE,1/19/2016,001612,211816,63058,69894,35358,2,8115,33120,46709,20266,19374,29353,12036,191327,186375,20489,25441,-6836,6050,-70899,83.25384345,35356,49647,25622,40.51612903,-13589,45752,-24100,15.04752906,892,15927,-15137,51.59992274,472.75,843,451.5,5.427841635
WHEAT-HRW - CHICAGO BOARD OF TRADE,1/12/2016,001612,209846,65027,69426,35764,0,7388,31764,47232,20126,18898,30314,10266,189233,184752,20613,25094,-4399,6050,-70899,86.42087616,35764,49647,25622,42.21436004,-15468,45752,-24100,12.35755598,1228,15927,-15137,52.68156065,480.75,843,451.5,7.471264368
WHEAT-HRW - CHICAGO BOARD OF TRADE,1/5/2016,001612,204323,67579,67231,33575,0,4807,32915,51055,17566,18198,27838,9966,184606,178463,19717,25860,348,6050,-70899,92.5898972,33575,49647,25622,33.10301769,-18140,45752,-24100,8.532325488,-632,15927,-15137,46.69392223,460,843,451.5,2.171136654
WHEAT-HRW - CHICAGO BOARD OF TRADE,12/29/2015,001612,190323,60201,65243,32313,0,3852,32017,46987,15460,18565,25324,9171,171579,166037,18744,24286,-5042,6050,-70899,85.58525777,32313,49647,25622,27.85015609,-14970,45752,-24100,13.0704919,-3105,15927,-15137,38.73293845,473.25,843,451.5,5.555555556
WHEAT-HRW - CHICAGO BOARD OF TRADE,12/22/2015,001612,188114,59917,64099,31370,0,3873,31178,46221,13978,18377,23593,9734,168427,161498,19687,26616,-4182,6050,-70899,86.70288113,31370,49647,25622,23.92507804,-15043,45752,-24100,12.96598523,-4399,15927,-15137,34.56734484,470.5,844.5,451.5,4.834605598
WHEAT-HRW - CHICAGO BOARD OF TRADE,12/15/2015,001612,182653,56778,60194,30465,21,2797,34693,49530,11267,18925,26643,7800,162725,158252,19928,24401,-3416,6050,-70899,87.69834566,30444,49647,25622,20.07075963,-14837,45752,-24100,13.26089446,-7658,15927,-15137,24.07610095,492.25,860.5,451.5,9.963325183
WHEAT-HRW - CHICAGO BOARD OF TRADE,12/8/2015,001612,190229,61657,56714,31150,0,2525,35468,57482,11045,19766,29255,8588,170199,165609,20030,24620,4943,6050,-70899,98.56138481,31150,49647,25622,23.00936524,-22014,45752,-24100,2.986313921,-8721,15927,-15137,20.6541334,459.25,868.75,451.5,1.857399641
WHEAT-HRW - CHICAGO BOARD OF TRADE,12/1/2015,001612,193267,62459,56409,31987,0,2403,36908,60700,10814,20174,29941,8444,173189,168711,20078,24556,6050,6050,-73687,100,31987,49647,25622,26.49323621,-23792,45752,-24100,0.440932257,-9360,15927,-15137,18.59708988,451.5,887.75,451.5,0
WHEAT-HRW - CHICAGO BOARD OF TRADE,11/24/2015,001612,196312,65053,59306,32282,28,2433,36580,60680,9603,19739,28992,8791,174481,169833,21831,26479,5747,5747,-74374,100,32254,49647,25622,27.60457856,-24100,45752,-24100,0,-10136,15927,-15137,16.09902138,457.5,915.75,452,1.185983827
WHEAT-HRW - CHICAGO BOARD OF TRADE,11/17/2015,001612,202782,66214,63697,31673,854,2749,36005,58964,9984,22538,27267,10741,179904,174256,22878,28526,2517,4386,-75175,97.65085909,30819,49647,25622,21.63163371,-22959,45752,-22959,0,-12554,15927,-15137,8.315091424,463.25,915.75,452,2.425876011
WHEAT-HRW - CHICAGO BOARD OF TRADE,11/10/2015,001612,205827,62053,62482,31106,958,3559,36551,57012,11360,23077,27436,15694,183400,178501,22427,27326,-429,4386,-82081,94.43140158,30148,49647,25622,18.83870968,-20461,46933,-20461,0,-11717,15927,-15137,11.00952871,460.75,915.75,452,1.886792453
WHEAT-HRW - CHICAGO BOARD OF TRADE,11/3/2015,001612,199860,57970,63567,30800,806,5062,36980,53179,10022,23154,27179,14193,178181,174008,21679,25852,-5597,4386,-84519,88.77116023,29994,49647,25622,18.19771072,-16199,49126,-16199,0,-13132,15927,-15137,6.454416688,487.5,919.5,452,7.593582888
WHEAT-HRW - CHICAGO BOARD OF TRADE,10/27/2015,001612,195999,56476,65017,31553,806,3006,39043,51238,10673,21315,27563,11808,173874,170111,22125,25888,-8541,4386,-84643,85.48001213,30747,49647,25622,21.33194589,-12195,51650,-14385,3.316423109,-10642,15927,-15137,14.47012619,488,919.5,452,7.700534759
WHEAT-HRW - CHICAGO BOARD OF TRADE,10/20/2015,001612,192268,54257,66830,30430,806,2720,40861,49834,10117,22020,26117,10251,170656,166675,21612,25593,-12573,4386,-84643,80.95115075,29624,49647,25622,16.65764828,-8973,51650,-14385,8.19565382,-11903,15927,-15137,10.41076487,476.5,919.5,452,5.240641711
WHEAT-HRW - CHICAGO BOARD OF TRADE,10/13/2015,001612,185121,49501,70523,31640,1091,2454,38960,43425,9063,22534,24663,10588,164740,161807,20381,23314,-21022,4386,-84643,71.46098462,30549,49647,25622,20.50780437,-4465,51650,-14385,15.02233664,-13471,15927,-15137,5.363121298,511,919.5,452,12.62032086
WHEAT-HRW - CHICAGO BOARD OF TRADE,10/6/2015,001612,188562,51150,72954,32190,1087,2109,37332,44015,10960,23819,24165,10035,167595,165325,20967,23237,-21804,4386,-84643,70.58261915,31103,49647,25622,22.81373569,-6683,51650,-14385,11.66351177,-12859,15927,-15137,7.333247489,515.75,919.5,452,13.63636364
WHEAT-HRW - CHICAGO BOARD OF TRADE,9/29/2015,001612,185177,51640,70533,31034,1686,2767,37680,44907,11207,22405,23052,7442,164175,161594,21002,23583,-18893,4386,-84643,73.85234025,29348,49647,25622,15.50884495,-7227,51650,-14385,10.83970622,-11198,15927,-15137,12.68027298,494.75,919.5,452,9.144385027
WHEAT-HRW - CHICAGO BOARD OF TRADE,9/22/2015,001612,188020,51653,65798,30674,1676,4811,39142,47598,10727,22291,23961,9019,168317,163590,19703,24430,-14145,4386,-84643,79.18543396,28998,49647,25622,14.05202914,-8456,51650,-14385,8.978571969,-11564,15927,-15137,11.50206026,488,919.5,452,7.700534759
WHEAT-HRW - CHICAGO BOARD OF TRADE,9/15/2015,001612,186652,51197,65522,29258,1802,5728,40714,48072,9884,22375,23560,8307,167463,162875,19189,23777,-14325,4386,-84643,78.98325265,27456,49647,25622,7.63371488,-7358,51650,-14385,10.64132657,-12491,15927,-15137,8.517898532,492.5,919.5,452,8.663101604
WHEAT-HRW - CHICAGO BOARD OF TRADE,9/8/2015,001612,182171,51134,64637,29403,2391,6286,40475,48473,7453,21826,22510,7334,163911,159084,18260,23087,-13503,4386,-84643,79.9065473,27012,49647,25622,5.785639958,-7998,51650,-14385,9.67214356,-14373,15927,-15137,2.459438578,452,919.5,452,0
WHEAT-HRW - CHICAGO BOARD OF TRADE,9/1/2015,001612,179864,50742,65656,29712,2528,5244,39664,47988,7120,22257,20786,6949,161688,156271,18176,23593,-14914,4386,-84643,78.32167047,27184,49647,25622,6.501560874,-8324,51650,-14385,9.178465965,-15137,15927,-15137,0,458.5,919.5,458.5,0
WHEAT-HRW - CHICAGO BOARD OF TRADE,8/25/2015,001612,187037,52792,68375,28810,969,3931,40752,47691,8047,21382,22931,10080,165794,162024,21243,25013,-15583,4386,-84643,77.57022993,27841,49647,25622,9.236212279,-6939,51650,-14385,11.27583857,-13335,15927,-13335,0,466,919.5,466,0
WHEAT-HRW - CHICAGO BOARD OF TRADE,8/18/2015,001612,200401,55888,74275,28405,802,4129,39916,46827,15114,23999,22718,11265,178716,175130,21685,25271,-18387,4386,-84643,74.42069438,27603,49647,25622,8.245577523,-6911,51650,-14385,11.31824033,-8885,15927,-10622,6.542619308,476,919.5,476,0
WHEAT-HRW - CHICAGO BOARD OF TRADE,8/11/2015,001612,198333,56454,71884,28952,681,3772,39367,47327,14994,22584,23091,10695,176818,172444,21515,25889,-15430,4386,-84643,77.74208404,28271,49647,25622,11.02601457,-7960,51650,-14385,9.729688801,-7590,15927,-10622,11.42039248,488,919.5,485,0.690448792
WHEAT-HRW - CHICAGO BOARD OF TRADE,8/4/2015,001612,202218,59152,76625,29135,689,5085,39380,45573,15802,22474,21560,10365,181393,175699,20825,26519,-17473,4386,-84643,75.44732615,28446,49647,25622,11.75442248,-6193,51650,-14385,12.40554252,-6672,15927,-10622,14.87814984,485,919.5,485,0
WHEAT-HRW - CHICAGO BOARD OF TRADE,7/28/2015,001612,195075,56263,80238,29610,550,4980,37963,38423,17398,19912,19266,7553,173679,168408,21396,26667,-23975,4386,-84643,68.14408788,29060,49647,25622,14.31009365,-460,51650,-14385,21.08730219,-2514,15927,-10622,30.53975668,504.75,919.5,486.25,4.270051933
WHEAT-HRW - CHICAGO BOARD OF TRADE,7/21/2015,001612,199141,56538,86785,30239,403,4767,38079,32218,17197,20334,17273,12343,179497,170986,19644,28155,-30247,4386,-84643,61.0991924,29836,49647,25622,17.54006243,5861,51650,-14385,30.65949875,-3137,15927,-10622,28.19315228,518,919.5,486.25,7.328332372
WHEAT-HRW - CHICAGO BOARD OF TRADE,7/14/2015,001612,192063,53098,87926,30502,683,5537,35353,28465,15817,20932,14470,11859,173098,164757,18965,27306,-34828,4386,-84643,55.95367802,29819,49647,25622,17.46930281,6888,51650,-14385,32.21473461,-5115,15927,-10622,20.74277751,550,919.5,486.25,14.71436815
WHEAT-HRW - CHICAGO BOARD OF TRADE,7/7/2015,001612,185914,51317,81102,30447,1160,4843,36144,29898,14574,19498,16544,11412,168235,159533,17679,26381,-29785,4386,-84643,61.61812443,29287,49647,25622,15.25494277,6246,51650,-14385,31.2425229,-4924,15927,-10622,21.46220197,570.75,919.5,486.25,19.50375072
WHEAT-HRW - CHICAGO BOARD OF TRADE,6/30/2015,001612,183836,50210,70908,29078,1197,4405,38261,36163,15160,19330,20387,10955,167399,159175,16437,24661,-20698,4386,-84643,71.82491098,27881,49647,25622,9.402705515,2098,51650,-14385,24.96100553,-4170,15927,-10622,24.30223361,593.25,919.5,486.25,24.69705713
WHEAT-HRW - CHICAGO BOARD OF TRADE,6/23/2015,001612,171911,48770,55090,28144,1215,2018,36620,39098,12822,11471,26038,13019,152864,149300,19047,22611,-6320,4386,-84643,87.97470487,26929,49647,25622,5.440166493,-2478,51650,-14385,18.03134701,1351,15927,-10622,45.09774379,530.25,919.5,486.25,10.15579919
WHEAT-HRW - CHICAGO BOARD OF TRADE,6/16/2015,001612,162519,41726,52270,29268,1737,1430,32857,33897,15992,11643,21950,11265,144181,138541,18338,23978,-10544,4386,-84643,83.23018342,27531,49647,25622,7.945889698,-1040,51650,-14385,20.20898009,4349,15927,-10622,56.39007119,506.5,919.5,486.25,4.673975765
WHEAT-HRW - CHICAGO BOARD OF TRADE,6/9/2015,001612,161406,41090,52435,29266,1617,1509,31326,32350,15120,10365,19648,13530,142206,136209,19200,25197,-11345,4386,-84643,82.33047659,27649,49647,25622,8.437044745,-1024,51650,-14385,20.23320966,4755,15927,-10622,57.919319,548.25,919.5,486.25,14.31044432
WHEAT-HRW - CHICAGO BOARD OF TRADE,6/2/2015,001612,160483,39988,48058,29287,1549,4300,31896,32193,14630,10402,23747,12087,142590,136564,17893,23919,-8070,4386,-84643,86.00905323,27738,49647,25622,8.807492196,-297,51650,-14385,21.33414099,4228,15927,-10622,55.93431014,535.5,919.5,486.25,11.36757069
WHEAT-HRW - CHICAGO BOARD OF TRADE,5/26/2015,001612,155898,38631,50083,28547,1079,3711,34244,29946,12477,9807,23706,11127,138544,132129,17354,23769,-11452,4386,-84643,82.21029103,27468,49647,25622,7.683662851,4298,51650,-14385,28.29257212,2670,15927,-10622,50.06591585,524.5,919.5,486.25,8.828620889
WHEAT-HRW - CHICAGO BOARD OF TRADE,5/19/2015,001612,155439,40089,46166,29987,1172,2360,33660,34665,11168,10691,26433,10260,138215,132224,17224,23215,-6077,4386,-84643,88.24764964,28815,49647,25622,13.29032258,-1005,51650,-14385,20.26198228,477,15927,-10622,41.80571773,540,919.5,486.25,12.40623197
WHEAT-HRW - CHICAGO BOARD OF TRADE,5/12/2015,001612,159809,43500,42440,29245,1396,2935,30988,41023,11188,11916,27715,10683,140455,137380,19354,22429,1060,4386,-84643,96.26413865,27849,49647,25622,9.269510926,-10035,51650,-14385,6.587415764,-728,15927,-10622,37.26694037,508.25,919.5,486.25,5.077899596
WHEAT-HRW - CHICAGO BOARD OF TRADE,5/5/2015,001612,165655,44646,40260,27799,1658,6729,30033,44418,12395,12598,25182,12469,146669,143111,18986,22544,4386,4386,-84643,100,26141,49647,25622,2.16024974,-14385,51650,-14385,0,-203,15927,-10622,39.24441599,486.25,919.5,486.25,0
WHEAT-HRW - CHICAGO BOARD OF TRADE,4/28/2015,001612,166205,44939,44234,29026,1675,6945,30686,43759,11493,11792,23460,11802,146683,143368,19522,22837,705,705,-84643,100,27351,49647,25622,7.196670135,-13073,51650,-13073,0,-299,15927,-10622,38.88282045,497.25,919.5,497.25,0
WHEAT-HRW - CHICAGO BOARD OF TRADE,4/21/2015,001612,158203,43775,46651,28499,2877,3154,27422,38907,10485,12741,21234,11497,137573,134805,20630,23398,-2876,-2876,-84643,100,25622,49647,25622,0,-11485,51650,-11485,0,-2256,15927,-10622,31.51154469,513.75,919.5,513.75,0
WHEAT-HRW - CHICAGO BOARD OF TRADE,4/14/2015,001612,153133,42620,51795,29027,3183,5025,25593,27090,8430,12075,22669,11543,134313,129735,18820,23398,-9175,-8393,-84643,98.97442623,25844,49647,25844,0,-1497,51650,-7734,10.50282904,-3645,15927,-10622,26.27970922,521.75,919.5,521.75,0
WHEAT-HRW - CHICAGO BOARD OF TRADE,4/7/2015,001612,147321,38580,55931,30737,3372,5250,28918,21680,7506,11454,23232,9005,131450,125976,15871,21345,-17351,-8393,-84643,88.25180328,27365,49647,26992,1.646435665,7238,51650,-7734,25.21217836,-3948,15927,-10622,25.13842329,565.25,919.5,530.5,8.933161954
WHEAT-HRW - CHICAGO BOARD OF TRADE,3/31/2015,001612,154679,39962,53591,30564,3572,5920,30413,25403,8461,12276,25369,10215,137811,132531,16868,22148,-13629,-8393,-84643,93.13311475,26992,49647,26992,0,5010,51650,-7734,21.46032601,-3815,15927,-10622,25.63938378,559.25,919.5,530.5,7.390745501
WHEAT-HRW - CHICAGO BOARD OF TRADE,3/24/2015,001612,153978,39306,51322,30842,2264,4895,32618,26521,8272,11061,26655,10175,137169,130104,16809,23874,-12016,-8393,-84643,95.24852459,28578,49647,27753,3.768155659,6097,51650,-7734,23.2907854,-2789,15927,-10622,29.50393612,565.25,919.5,530.5,8.933161954
WHEAT-HRW - CHICAGO BOARD OF TRADE,3/17/2015,001612,160160,43481,53554,30820,2280,3868,36724,32448,8881,11361,28436,8162,143297,137629,16863,22531,-10073,-8393,-84643,97.79672131,28540,49647,27345,5.358263833,4276,51650,-7734,20.22430284,-2480,15927,-10622,30.66782176,542.75,919.5,530.5,3.149100257
WHEAT-HRW - CHICAGO BOARD OF TRADE,3/10/2015,001612,161141,45995,54727,31338,2240,5283,38448,33178,5160,11081,28978,8317,145622,137883,15519,23258,-8732,-8393,-84643,99.55540984,29098,49647,27345,7.860281589,5270,51650,-7734,21.89815439,-5921,15927,-10622,17.70688162,534.75,919.5,530.5,1.092544987
WHEAT-HRW - CHICAGO BOARD OF TRADE,3/3/2015,001612,164037,47974,56367,31096,2394,7725,36502,34934,4694,11347,26448,9246,148584,141808,15453,22229,-8393,-8393,-84643,100,28702,49647,27345,6.084656085,1568,51650,-7734,15.66415196,-6653,15927,-10622,14.94971562,530.5,919.5,530.5,0
WHEAT-HRW - CHICAGO BOARD OF TRADE,2/24/2015,001612,157937,42923,59043,33474,2646,7535,37381,30923,3370,8651,24244,9139,142473,136900,15464,21037,-16120,-16120,-84643,100,30828,49647,27345,15.61743341,6458,51650,-7734,23.89869325,-5281,15927,-10622,20.11751855,535.75,919.5,535.75,0
WHEAT-HRW - CHICAGO BOARD OF TRADE,2/17/2015,001612,156821,37522,62129,33094,2513,5423,36504,25565,5278,11665,22635,11255,140741,134798,16080,22023,-24607,-17213,-84643,89.03455435,30581,49647,27345,14.50990943,10939,51650,-7734,31.44449683,-6387,15927,-10622,15.9516366,562.25,919.5,550.25,3.249830738
WHEAT-HRW - CHICAGO BOARD OF TRADE,2/10/2015,001612,160200,38870,62603,32739,2197,6126,36246,24062,6312,11456,22820,11975,143724,136095,16476,24105,-23733,-17213,-84643,90.33071333,30542,49647,27345,14.33503722,12184,51650,-7734,33.54102115,-5144,15927,-10622,20.63354552,554,919.5,550.25,1.015572106
WHEAT-HRW - CHICAGO BOARD OF TRADE,2/3/2015,001612,166438,43965,66096,32341,1835,7660,37021,25308,7156,11324,23334,10412,149879,141801,16559,24637,-22131,-17213,-84643,92.70651046,30506,49647,27345,14.17361672,11713,51650,-7734,32.74787822,-4168,15927,-10622,24.30976685,559,919.5,550.25,2.369668246
WHEAT-HRW - CHICAGO BOARD OF TRADE,1/27/2015,001612,153825,40306,64848,30821,3068,5898,33822,21638,5580,10889,19880,9045,136361,129957,17464,23868,-24542,-17213,-84643,89.13095062,27753,49647,27345,1.829432338,12184,51650,-7734,33.54102115,-5309,15927,-10622,20.01205318,550.25,919.5,550.25,0
WHEAT-HRW - CHICAGO BOARD OF TRADE,1/20/2015,001612,143695,35031,64129,31014,2958,5130,34349,17619,6163,7927,17172,6280,125894,119451,17801,24244,-29098,-17213,-84643,82.3743141,28056,49647,27345,3.188054883,16730,51650,-7734,41.19628183,-1764,15927,-10622,33.36472184,577.75,919.5,558,5.463347165
WHEAT-HRW - CHICAGO BOARD OF TRADE,1/13/2015,001612,132736,28466,64158,30706,1618,5383,34777,14214,3400,8221,14574,5103,116056,108450,16680,24286,-35692,-17213,-84643,72.595284,29088,49647,27345,7.815442561,20563,51650,-7734,47.65088239,-4821,15927,-10622,21.85016385,581.75,919.5,558,6.569847856
WHEAT-HRW - CHICAGO BOARD OF TRADE,1/6/2015,001612,130911,24110,65676,31781,2405,4127,36451,13840,4254,7648,12854,5290,113661,108446,17250,22465,-41566,-17213,-84643,63.88402788,29376,49647,25903,14.6268531,22611,51650,-7734,51.09962279,-3394,15927,-10622,27.22513089,631.25,919.5,558,20.26279391
WHEAT-HRW - CHICAGO BOARD OF TRADE,12/30/2014,001612,130717,24076,67439,31446,2085,3314,37611,12046,4681,7774,14267,4995,113897,108827,16820,21890,-43363,-17213,-84643,61.21904197,29361,49647,24684,18.73572888,25565,51650,-7734,56.07402667,-3093,15927,-10622,28.35888357,636,919.5,558,21.57676349
WHEAT-HRW - CHICAGO BOARD OF TRADE,12/23/2014,001612,129362,23090,69049,31983,1505,2759,38106,11994,3049,8732,14053,5070,112789,107479,16573,21883,-45959,-17213,-84643,57.36912354,30478,49647,24209,24.64423304,26112,51650,-7734,56.99515021,-5683,15927,-10622,18.60333723,664.75,919.5,558,29.52973721
WHEAT-HRW - CHICAGO BOARD OF TRADE,12/16/2014,001612,128499,24064,64808,33387,1008,2554,34087,13421,3557,8459,15412,5838,111946,106598,16553,21901,-40744,-17213,-84643,65.10306985,32379,49647,24209,32.11730482,20666,51650,-7734,47.82432979,-4902,15927,-10622,21.54506761,654.75,919.5,558,26.76348548
WHEAT-HRW - CHICAGO BOARD OF TRADE,12/9/2014,001612,131160,24941,65046,36184,1021,1856,35488,11996,5374,8150,18169,5725,117718,109187,13442,21973,-40105,-17213,-84643,66.05071926,35163,49647,23613,44.36506107,23492,51650,-7734,52.58318739,-2776,15927,-10622,29.55290218,617,919.5,558,16.3208852
WHEAT-HRW - CHICAGO BOARD OF TRADE,12/2/2014,001612,139445,26096,67144,38249,1048,1842,35874,13551,8482,7577,18650,6259,124379,116976,15066,22469,-41048,-17213,-84643,64.65223194,37201,49647,23556,52.29772719,22323,51650,-7734,50.61464368,905,15927,-10622,43.41783118,648.75,919.5,558,25.10373444
WHEAT-HRW - CHICAGO BOARD OF TRADE,11/25/2014,001612,143534,29161,60385,38178,1013,2281,36033,22189,11541,5929,17638,5262,128385,120309,15149,23225,-31224,-17213,-84643,79.2214148,37165,49647,23344,52.54533703,13844,51650,-7734,36.33638691,5612,15927,-10622,61.14731252,617.25,919.5,558,16.39004149
WHEAT-HRW - CHICAGO BOARD OF TRADE,11/18/2014,001612,150426,31013,60675,36719,1078,3840,35353,22697,13404,8807,18365,5719,134855,125778,15571,24648,-29662,-17213,-84643,81.53789115,35641,49647,22178,49.01161309,12656,51650,-7734,34.33584804,4597,15927,-10622,57.324193,593.5,919.5,558,9.820193638
WHEAT-HRW - CHICAGO BOARD OF TRADE,11/11/2014,001612,160533,31317,58157,35923,1138,3770,38673,26875,16581,10580,19337,6259,143103,132117,17430,28416,-26840,-17213,-84643,85.72297197,34785,49647,22178,45.89537297,11798,51650,-7734,32.89101441,6001,15927,-10622,62.61252778,578.5,919.5,558,5.670816044
WHEAT-HRW - CHICAGO BOARD OF TRADE,11/4/2014,001612,157692,30143,62212,35417,1318,3864,39625,24068,15447,11435,17703,5223,141154,129835,16538,27857,-32069,-17213,-84643,77.96826338,34099,49647,21938,43.88826735,15557,51650,-7734,39.22100229,4012,15927,-10622,55.12072018,590.25,919.5,558,8.921161826
WHEAT-HRW - CHICAGO BOARD OF TRADE,10/28/2014,001612,159186,28298,61742,37583,1078,3821,40780,25971,16321,10804,17156,4510,142117,130599,17069,28587,-33444,-17213,-84643,75.92911167,36505,49647,21938,52.5713667,14809,51650,-7734,37.96140375,5517,15927,-10622,60.7894836,602,919.5,558,12.17150761
WHEAT-HRW - CHICAGO BOARD OF TRADE,10/21/2014,001612,154405,28090,61870,37653,978,3437,41718,26605,13084,9729,16700,4581,138292,127255,16113,27150,-33780,-17213,-84643,75.43081714,36675,49647,21938,53.18488578,15113,51650,-7734,38.47332615,3355,15927,-10622,52.6460507,602.25,919.5,558,12.2406639
WHEAT-HRW - CHICAGO BOARD OF TRADE,10/14/2014,001612,155622,31211,59045,36676,727,3405,40613,31271,11104,10252,16463,6447,139708,128462,15914,27160,-27834,-17213,-84643,84.24885066,35949,49647,21938,50.56479844,9342,51650,-7734,28.75522026,852,15927,-10622,43.21820031,590.25,919.5,558,8.921161826
WHEAT-HRW - CHICAGO BOARD OF TRADE,10/7/2014,001612,157656,33808,60306,36798,628,3179,40343,32970,11686,10363,16504,6572,142749,131845,14907,25811,-26498,-17213,-84643,86.23016462,36170,49647,21938,51.36237324,7373,51650,-7734,25.43951233,1323,15927,-10622,44.99227843,588.25,919.5,558,8.36791148
WHEAT-HRW - CHICAGO BOARD OF TRADE,9/30/2014,001612,151310,32905,59158,36149,651,2761,39034,31358,8183,11551,16490,5603,136186,124204,15124,27106,-26253,-17213,-84643,86.59350437,35498,49647,21938,48.93716843,7676,51650,-7734,25.94975077,-3368,15927,-10622,27.32306302,558,919.5,558,0
WHEAT-HRW - CHICAGO BOARD OF TRADE,9/23/2014,001612,149085,34476,60266,36976,658,2707,36738,29938,7951,11041,16516,4789,134678,122825,14407,26260,-25790,-17213,-84643,87.28014237,36318,49647,21938,51.89649572,6800,51650,-7734,24.47460595,-3090,15927,-10622,28.37018343,562,919.5,562,0
WHEAT-HRW - CHICAGO BOARD OF TRADE,9/16/2014,001612,145073,31212,60513,36786,721,2288,36618,28976,7572,11507,15666,4349,130332,120085,14741,24988,-29301,-17213,-84643,82.07326116,36065,49647,21938,50.98343499,7642,51650,-7734,25.8924963,-3935,15927,-10622,25.18738936,583.25,919.5,583.25,0
WHEAT-HRW - CHICAGO BOARD OF TRADE,9/9/2014,001612,137693,25502,59080,36813,682,2091,38234,25285,6042,10585,16568,3518,122785,113266,14908,24427,-33578,-17213,-84643,75.73038707,36131,49647,21938,51.22162474,12949,51650,-7734,34.82924694,-4543,15927,-10622,22.89728427,613,919.5,611.5,0.487012987
WHEAT-HRW - CHICAGO BOARD OF TRADE,9/2/2014,001612,133681,25987,56304,36224,2443,963,38105,23959,6133,9688,16696,1658,118758,108156,14923,25525,-30317,-17213,-84643,80.56651342,33781,49647,21938,42.74062579,14146,51650,-7734,36.8449414,-3555,15927,-10622,26.61870504,617.5,919.5,611.5,1.948051948
WHEAT-HRW - CHICAGO BOARD OF TRADE,8/26/2014,001612,136627,27542,58654,36280,2554,1476,37045,23724,6143,9402,16723,2134,120022,111408,16605,25219,-31112,-17213,-84643,79.38751298,33726,49647,21938,42.54213432,13321,51650,-7734,35.4556783,-3259,15927,-10622,27.73362462,621,919.5,611.5,3.084415584
WHEAT-HRW - CHICAGO BOARD OF TRADE,8/19/2014,001612,139568,29692,64394,35852,1322,1970,37204,21677,4913,10505,15164,2511,122647,111951,16921,27617,-34702,-17213,-84643,74.06347323,34530,49647,21938,45.44371865,15527,51650,-7734,39.17048363,-5592,15927,-10622,18.94609966,624.5,919.5,611.5,4.220779221
WHEAT-HRW - CHICAGO BOARD OF TRADE,8/12/2014,001612,140969,29808,64229,35447,1446,1402,35966,22883,5600,11965,13911,3490,123678,112961,17291,28008,-34421,-17213,-84643,74.48020169,34001,49647,21938,43.53459165,13083,51650,-7734,35.05489694,-6365,15927,-10622,16.03450224,613.25,919.5,611.5,0.568181818
WHEAT-HRW - CHICAGO BOARD OF TRADE,8/5/2014,001612,143984,30203,67255,37771,1146,1366,38910,24290,4980,10626,14193,3370,127226,116600,16758,27384,-37052,-17213,-84643,70.57837758,36625,49647,21938,53.00443899,14620,51650,-7734,37.6431362,-5646,15927,-10622,18.74270217,642.75,919.5,611.5,10.1461039
WHEAT-HRW - CHICAGO BOARD OF TRADE,7/29/2014,001612,142048,27969,63170,36609,967,982,37175,24518,6491,12502,13599,4152,125880,113879,16168,28169,-35201,-17213,-84643,73.32344654,35642,49647,21938,49.45685517,12657,51650,-7734,34.337532,-6011,15927,-10622,17.3678858,611.5,919.5,611.5,0
WHEAT-HRW - CHICAGO BOARD OF TRADE,7/22/2014,001612,142865,26923,64156,36239,1017,1054,39602,25055,6387,11912,13718,4040,126157,115427,16708,27438,-37233,-17213,-84643,70.30995106,35222,49647,21938,47.94110217,14547,51650,-7734,37.52020746,-5525,15927,-10622,19.19846322,621.25,919.5,621.25,0
WHEAT-HRW - CHICAGO BOARD OF TRADE,7/15/2014,001612,141188,26589,64805,36538,1112,1060,38919,24264,4290,12611,13410,5173,125180,114114,16008,27074,-38216,-17213,-84643,68.85214296,35426,49647,21938,48.67732506,14655,51650,-7734,37.70207463,-8321,15927,-10622,8.666993107,639,919.5,621.25,5.951383068
WHEAT-HRW - CHICAGO BOARD OF TRADE,7/8/2014,001612,135001,25316,68551,34810,1228,690,38953,20599,3307,13929,13571,3289,120294,111235,14707,23766,-43235,-17213,-84643,61.40886846,33582,49647,21938,42.02244758,18354,51650,-7734,43.93102519,-10622,15927,-10622,0,675,919.5,621.25,18.0217938
WHEAT-HRW - CHICAGO BOARD OF TRADE,7/1/2014,001612,133669,23442,70076,33698,1249,743,41189,17963,3339,12300,13673,3957,118668,111000,15001,22669,-46634,-17213,-84643,56.36808542,32449,49647,21938,37.9335234,23226,51650,-7734,52.13525529,-8961,15927,-8961,0,700,919.5,621.25,26.40402347
WHEAT-HRW - CHICAGO BOARD OF TRADE,6/24/2014,001612,138382,25168,70585,32904,1198,961,41640,16206,5295,10416,14522,5474,121858,114241,16524,24141,-45417,-17213,-84643,58.17292007,31706,49647,21938,35.25208416,25434,51650,-7734,55.85342853,-5121,15927,-5960,3.833325718,705.5,919.5,621.25,28.248114
WHEAT-HRW - CHICAGO BOARD OF TRADE,6/17/2014,001612,139027,26261,68869,35207,131,1045,38693,13727,5964,9954,16953,5816,122940,112505,16087,26522,-42608,-17213,-84643,62.33872164,35076,49647,21938,47.41419755,24966,51650,-7734,55.06533746,-3990,15927,-5960,9.000776717,712.5,919.5,621.25,30.59513831
WHEAT-HRW - CHICAGO BOARD OF TRADE,6/10/2014,001612,141333,27911,71487,34340,358,1173,37855,12847,5991,10477,17410,6077,123824,115343,17509,25990,-43576,-17213,-84643,60.90315883,33982,49647,20030,47.10807982,25008,51650,-7734,55.13606359,-4486,15927,-5960,6.73459131,726,919.5,621.25,35.12154233
WHEAT-HRW - CHICAGO BOARD OF TRADE,6/3/2014,001612,144935,30757,77276,34140,746,1537,41322,11305,5660,10393,16960,4220,128029,117704,16906,27231,-46519,-17213,-84643,56.53863266,33394,49647,20030,45.12273357,30017,51650,-7734,63.57099555,-4733,15927,-5960,5.606067529,707.75,919.5,621.25,29.00251467
WHEAT-HRW - CHICAGO BOARD OF TRADE,5/27/2014,001612,142821,31031,78563,34412,763,1655,39951,10138,6780,9343,16263,3115,126287,117277,16534,25544,-47532,-17213,-84643,55.03633398,33649,49647,20030,45.98372556,29813,51650,-7734,63.22746868,-2563,15927,-5960,15.52062868,738.25,919.5,621.25,39.22883487
WHEAT-HRW - CHICAGO BOARD OF TRADE,5/20/2014,001612,146465,28859,79860,33757,498,1580,43150,10568,9235,9297,16826,3176,129054,121743,17411,24722,-51001,-17213,-84643,49.89173958,33259,49647,20030,44.66691427,32582,51650,-7734,67.89034083,-62,15927,-5960,26.94750308,768.25,919.5,621.25,49.28751048
WHEAT-HRW - CHICAGO BOARD OF TRADE,5/13/2014,001612,146100,26453,79072,34182,498,1564,44328,9748,9243,8914,18213,2677,127361,121015,18739,25085,-52619,-17213,-84643,47.49221415,33684,49647,20014,46.1310026,34580,51650,-7734,71.25488347,329,15927,-5960,28.73395166,824.25,919.5,621.25,68.06370495
WHEAT-HRW - CHICAGO BOARD OF TRADE,5/6/2014,001612,150685,27853,84741,34424,795,2455,45039,8117,8431,8890,16226,5105,132197,125870,18488,24815,-56888,-17213,-84643,41.16120421,33629,49647,20014,45.94539871,36922,51650,-7734,75.19870672,-459,15927,-5960,25.13364097,843,932.5,621.25,71.24497992
WHEAT-HRW - CHICAGO BOARD OF TRADE,4/29/2014,001612,143239,26214,79256,34881,827,2642,43957,8389,6552,8134,17039,4521,126901,119226,16338,24013,-53042,-17213,-84643,46.86489693,34054,49647,20014,47.37961057,35568,51650,-7734,72.91863128,-1582,15927,-5960,20.00274135,797.25,932.5,621.25,56.54618474
WHEAT-HRW - CHICAGO BOARD OF TRADE,4/22/2014,001612,142067,26918,77054,33292,1430,3652,42136,6485,7459,8649,16824,3037,125143,115941,16924,26126,-50136,-17213,-84643,51.17455139,31862,49647,19869,40.27469944,35651,51650,-7734,73.05839957,-1190,15927,-5960,21.79375885,741.25,950.25,621.25,36.47416413
WHEAT-HRW - CHICAGO BOARD OF TRADE,4/15/2014,001612,145723,29486,77879,33054,1320,3804,41037,4728,8831,8072,18463,3985,128269,119010,17454,26713,-48393,-17213,-84643,53.75945425,31734,49647,19431,40.71683876,36309,51650,-7734,74.16644214,759,15927,-5960,30.6985882,765.5,950.25,621.25,43.8449848
WHEAT-HRW - CHICAGO BOARD OF TRADE,4/8/2014,001612,146183,28093,80478,32577,1357,3082,45950,4286,8731,7274,19118,2218,127925,119270,18258,26913,-52385,-17213,-84643,47.83924069,31220,49647,17658,42.39582356,41664,51650,-7734,83.18402263,1457,15927,-5960,33.88769589,741.5,950.25,621.25,36.55015198
WHEAT-HRW - CHICAGO BOARD OF TRADE,4/1/2014,001612,148198,26191,83595,31883,1299,3294,49134,3382,10318,7271,17537,2595,130686,122020,17512,26178,-57404,-17213,-84643,40.39596619,30584,49647,17108,41.41491748,45752,51650,-7734,90.06803179,3047,15927,-5960,41.15228218,753.5,950.25,621.25,40.19756839
WHEAT-HRW - CHICAGO BOARD OF TRADE,3/25/2014,001612,147947,27949,83331,32757,904,2697,47137,4185,9621,7667,18527,2343,130171,121608,17776,26339,-55382,-17213,-84643,43.39463147,31853,49647,17108,45.31485295,42952,51650,-7734,85.35295703,1954,15927,-5960,36.15845022,791.75,950.25,621.25,51.82370821
WHEAT-HRW - CHICAGO BOARD OF TRADE,3/18/2014,001612,135239,23518,72517,31778,994,2956,43087,6036,6784,8266,17026,2626,119015,108939,16224,26300,-48999,-17213,-84643,52.86074448,30784,49647,17108,42.02956452,37051,51650,-7734,75.41593695,-1482,15927,-5960,20.45963357,763.25,950.25,621.25,43.16109422
WHEAT-HRW - CHICAGO BOARD OF TRADE,3/11/2014,001612,128769,21631,67505,32157,957,2801,41776,8832,5859,8345,16366,2047,114616,104367,14153,24402,-45874,-17213,-84643,57.49518019,31200,49647,17108,43.30803036,32944,51650,-7734,68.49993264,-2486,15927,-5960,15.87243569,722,950.25,621.25,30.6231003
WHEAT-HRW - CHICAGO BOARD OF TRADE,3/4/2014,001612,129590,23288,65979,33397,967,2804,41237,13040,5243,8457,15912,2246,116672,106191,12918,23399,-42691,-17213,-84643,62.21563102,32430,49647,16454,48.13062995,28197,51650,-7734,60.50619696,-3214,15927,-5960,12.54626034,704.25,950.25,621.25,25.22796353
WHEAT-HRW - CHICAGO BOARD OF TRADE,2/25/2014,001612,135949,25586,63582,33468,1149,3300,39874,16449,7148,10390,16994,3014,122780,111636,13169,24313,-37996,-17213,-84643,69.17840724,32319,49647,16454,47.7962221,23425,51650,-7734,52.47036239,-3242,15927,-5960,12.41833052,690.5,950.25,621.25,21.04863222
WHEAT-HRW - CHICAGO BOARD OF TRADE,2/18/2014,001612,145093,28775,64128,33057,1091,4276,39284,20579,9632,10287,14365,4240,129551,118311,15542,26782,-35353,-17213,-84643,73.09802758,31966,49647,16454,46.73274486,18705,51650,-7734,44.52209349,-655,15927,-5960,24.23813222,685.75,950.25,621.25,19.60486322
WHEAT-HRW - CHICAGO BOARD OF TRADE,2/11/2014,001612,146909,31993,61741,32509,1279,4492,38892,25770,8212,9076,13897,5311,130485,120702,16424,26207,-29748,-17213,-84643,81.41035148,31230,49647,16454,44.51540988,13122,51650,-7734,35.1205712,-864,15927,-5960,23.28322749,665.5,950.25,621.25,13.44984802
WHEAT-HRW - CHICAGO BOARD OF TRADE,2/4/2014,001612,159443,38090,63967,31659,1039,4681,41361,32949,10764,8747,11975,8519,143821,133894,15622,25549,-25877,-17213,-84643,87.15111968,30620,49647,16454,42.677673,8412,51650,-7734,27.18914186,2017,15927,-5960,36.44629232,646.5,972,621.25,7.198859587
WHEAT-HRW - CHICAGO BOARD OF TRADE,1/28/2014,001612,160310,35360,61193,31707,839,4363,40141,35103,12318,10699,10657,10190,144778,134663,15532,25647,-25833,-17213,-86141,87.49419684,30868,49647,16454,43.42481849,5038,51650,-7734,21.50747676,1619,15927,-5960,34.62786129,622,972,621.25,0.213827512
WHEAT-HRW - CHICAGO BOARD OF TRADE,1/21/2014,001612,159858,33137,60853,32699,726,5054,41465,34914,13685,9287,9705,8975,144302,133912,15556,25946,-27716,-17213,-86141,84.76236072,31973,49647,16454,46.75383364,6551,51650,-7734,24.05530109,4398,15927,-5960,47.32489606,621.25,972,621.25,0
WHEAT-HRW - CHICAGO BOARD OF TRADE,1/14/2014,001612,157174,32015,59850,32155,722,5130,39989,34353,13378,10038,9229,8377,141082,131039,16092,26135,-27835,-17213,-86141,84.58971681,31433,49647,16454,45.12698461,5636,51650,-7734,22.51448202,3340,15927,-5960,42.49097638,632,972,625,2.017291066
WHEAT-HRW - CHICAGO BOARD OF TRADE,1/7/2014,001612,158024,32218,61212,32236,117,4705,39332,32576,14746,9924,9464,7874,141035,130694,16989,27330,-28994,-17213,-86141,82.90825209,32119,49647,16454,47.19368542,6756,51650,-7734,24.40051192,4822,15927,-5960,49.26211907,645.25,972,625,5.83573487
WHEAT-HRW - CHICAGO BOARD OF TRADE,12/31/2013,001612,153891,30963,59987,31565,544,4565,38391,30355,13489,11613,10123,6915,137501,125978,16390,27913,-29024,-17213,-86141,82.86472841,31021,49647,16454,43.88575905,8036,51650,-7734,26.55597467,1876,15927,-5960,35.80207429,640.5,972,625,4.46685879
WHEAT-HRW - CHICAGO BOARD OF TRADE,12/24/2013,001612,149117,29253,61446,32801,885,3845,35618,27580,12919,12528,9651,6327,133291,122653,15826,26464,-32193,-17213,-86141,78.26717734,31916,49647,16430,46.62070626,8038,51650,-7734,26.55934258,391,15927,-5960,29.01722484,646.5,972,625,6.195965418
WHEAT-HRW - CHICAGO BOARD OF TRADE,12/17/2013,001612,147079,26075,63477,34023,786,2386,37965,23789,13076,11964,9892,6379,131868,119785,15211,27294,-37402,-17213,-86141,70.71001625,33237,49647,16430,50.59758557,14176,51650,-7734,36.89546006,1112,15927,-5960,32.31141774,660.5,972,625,10.23054755
WHEAT - KANSAS CITY BOARD OF TRADE,12/10/2013,001612,148025,23128,65164,35874,867,1253,42706,24931,13387,11142,9562,6257,133747,121421,14278,26604,-42036,-17213,-86141,63.98705896,35007,49647,15748,56.81288534,17775,51650,-7734,42.95601509,2245,15927,-5960,37.48800658,694.5,972,625,20.02881844
WHEAT - KANSAS CITY BOARD OF TRADE,12/3/2013,001612,146885,24509,70034,35248,946,1222,43536,22781,10967,11323,8672,5561,132366,120183,14519,26702,-45525,-17213,-86141,58.92525534,34302,49647,14280,56.61209602,20755,51650,-7734,47.97420181,-356,15927,-5960,25.60423996,711.75,972,625,25
WHEAT - KANSAS CITY BOARD OF TRADE,11/26/2013,001612,150190,26430,70249,35467,929,1585,43320,24116,10083,11250,10034,5337,133472,122333,16718,27857,-43819,-17213,-86141,61.40030176,34538,49647,14280,57.27938474,19204,51650,-7734,45.36238717,-1167,15927,-6094,22.37409745,704.25,972,625,22.83861671
WHEAT - KANSAS CITY BOARD OF TRADE,11/19/2013,001612,154141,27171,76407,35259,3007,2138,43903,19242,7934,13174,9773,6438,136017,124939,18124,29202,-49236,-17213,-86141,53.54137651,32252,49647,12690,52.93178559,24661,51650,-7734,54.55173111,-5240,15927,-6115,3.96969422,698.5,972,625,21.1815562
WHEAT - KANSAS CITY BOARD OF TRADE,11/12/2013,001612,154725,27877,83755,35991,3309,2027,46445,13178,7996,11740,10611,5318,137394,126194,17331,28531,-55878,-17213,-86141,43.90523445,32682,49647,11954,54.99164301,33267,53539,-7734,66.91528079,-3744,15927,-6115,10.75673714,703.25,972,625,22.55043228
WHEAT - KANSAS CITY BOARD OF TRADE,11/5/2013,001612,155047,23647,89130,37813,3737,2147,49048,6869,8403,10851,10393,5102,137011,125781,18036,29266,-65483,-17213,-97716,40.03950163,34076,49647,11954,58.68994243,42179,58301,-7734,75.58567426,-2448,15927,-6115,16.63642138,722.25,972,625,28.0259366
WHEAT - KANSAS CITY BOARD OF TRADE,10/29/2013,001612,159085,23306,93992,38737,3564,1863,49976,6055,8780,11213,11319,5781,139656,131354,19429,27731,-70686,-17213,-104067,38.43346305,35173,49647,11954,61.60029714,43921,61669,-7734,74.4276184,-2433,15927,-6115,16.70447328,751.75,972,625,36.52737752
WHEAT - KANSAS CITY BOARD OF TRADE,10/22/2013,001612,158135,22707,93606,38852,3627,1723,50144,6990,7124,12240,11644,5768,138558,130482,19577,27653,-70899,-17213,-104067,38.18822392,35225,49647,11954,61.73825379,43154,61669,-7734,73.32247886,-5116,15927,-6115,4.532256601,765.5,972,625,40.48991354
WHEAT - KANSAS CITY BOARD OF TRADE,10/15/2013,001612,155273,21791,92620,39388,3160,2117,49238,8134,6546,12506,12112,5778,137364,130467,17909,24806,-70829,-17213,-104067,38.26881894,36228,49647,11954,64.39922532,41104,61669,-7734,70.36871605,-5960,15927,-7740,7.521020831,756.25,972,625,37.82420749
WHEAT - KANSAS CITY BOARD OF TRADE,10/8/2013,001612,150209,23188,88369,38531,2983,2155,43732,10202,6603,12401,11146,5101,131711,126559,18498,23650,-65181,-17213,-104067,44.77168582,35548,49647,11954,62.59517682,33530,61669,-7734,59.45564313,-5798,15927,-9593,14.87068966,760.5,972,625,39.04899135
WHEAT - KANSAS CITY BOARD OF TRADE,10/1/2013,001612,151471,25252,83761,38973,2832,2672,42423,15566,7530,11253,10397,5254,133357,128012,18114,23459,-58509,-17213,-104067,52.45354273,36141,49647,11954,64.16841323,26857,61669,-7734,49.84078498,-3723,15927,-12740,31.45428542,745,972,625,34.58213256
WHEAT - KANSAS CITY BOARD OF TRADE,9/24/2013,001612,147563,21954,70460,39361,2621,3098,41493,25762,7295,11399,9392,5665,130265,124293,17298,23270,-48506,-17213,-104067,63.9705713,36740,49647,11954,65.75756772,15731,61669,-7734,33.80977768,-4104,15927,-14999,35.22925694,705,972,625,23.05475504
WHEAT - KANSAS CITY BOARD OF TRADE,9/17/2013,001612,147690,25076,72045,39443,2623,3131,40457,26587,7263,10368,8558,4517,130255,124724,17435,22966,-46969,-17213,-107719,67.1226217,36820,49647,11954,65.96980872,13870,61669,-7734,31.12833739,-3105,15927,-18199,44.23020571,690.25,972,625,18.80403458
WHEAT - KANSAS CITY BOARD OF TRADE,9/10/2013,001612,143096,26681,72602,38913,2550,2069,40329,26050,6001,9843,9001,3167,127003,121440,16093,21656,-45921,-17213,-107719,68.28055599,36363,49647,11954,64.75738201,14279,61669,-7734,31.71764909,-3842,15927,-18199,42.07056203,706.75,972,625,23.55907781
WHEAT - KANSAS CITY BOARD OF TRADE,9/3/2013,001612,136918,27545,71260,37962,2302,1512,39095,25003,4436,7861,7940,2561,120972,115014,15946,21904,-43715,-17213,-107719,70.71796345,35660,49647,11954,62.89231422,14092,61669,-7734,31.44820829,-3425,15927,-18199,43.29250425,696.75,972,625,20.67723343
WHEAT - KANSAS CITY BOARD OF TRADE,8/27/2013,001612,138668,28362,74427,37895,1498,2315,39887,25997,3802,8377,7777,2372,123010,118188,15658,20480,-46065,-17213,-107719,68.12145051,36397,49647,11954,64.84758443,13890,61669,-7734,31.15715459,-4575,15927,-18199,39.92263963,707.25,972,625,23.70317003
WHEAT - KANSAS CITY BOARD OF TRADE,8/20/2013,001612,139168,28847,70574,37795,1538,3423,38820,26137,3858,6731,8360,3524,122998,117414,16170,21754,-41727,-17213,-107719,72.91450291,36257,49647,11954,64.47616268,12683,61669,-7734,29.41803668,-2873,15927,-18199,44.91003927,696.75,972,625,20.67723343
WHEAT - KANSAS CITY BOARD OF TRADE,8/13/2013,001612,133902,27549,66104,36977,1538,3116,36390,26881,4662,6159,8035,2873,117726,113209,16176,20693,-38555,-17213,-107719,76.41924292,35439,49647,11954,62.30599846,9509,61669,-7734,24.84474735,-1497,15927,-18199,48.94215554,696.25,972,625,20.53314121
WHEAT - KANSAS CITY BOARD OF TRADE,8/6/2013,001612,138026,33156,65054,35932,1538,3971,32706,30749,5539,7107,7350,2523,120934,116724,17092,21302,-31898,-17213,-107719,83.77455638,34394,49647,11954,59.5336004,1957,61669,-7734,13.96337334,-1568,15927,-18199,48.73410303,702,972,625,22.19020173
WHEAT - KANSAS CITY BOARD OF TRADE,7/30/2013,001612,138182,37351,62207,34726,1498,3584,29985,33695,5647,7361,7738,2126,120780,116495,17402,21687,-24856,-17213,-107719,91.55525601,33228,49647,11954,56.44018783,-3710,61669,-7734,5.798020258,-1714,15927,-18199,48.30627674,696.25,972,625,20.53314121
WHEAT - KANSAS CITY BOARD OF TRADE,7/23/2013,001612,139691,39065,61556,35690,1498,2856,29984,34460,6308,6798,7734,2308,123009,116720,16682,22971,-22491,-17213,-107719,94.16834243,34192,49647,11954,58.99769188,-4476,61669,-7734,4.694321571,-490,15927,-18199,51.89298482,699,972,615,23.52941176
WHEAT - KANSAS CITY BOARD OF TRADE,7/16/2013,001612,142239,41663,60672,35922,1502,4280,27143,34374,6693,6309,7907,3238,125248,118666,16991,23573,-19009,-17213,-107719,98.01560118,34420,49647,11954,59.60257873,-7231,61669,-7734,0.724752532,384,15927,-18199,54.45408193,703.75,972,589.5,29.86928105
WHEAT - KANSAS CITY BOARD OF TRADE,7/9/2013,001612,140291,41661,58874,36051,1498,3465,26737,34471,7784,5871,7848,2811,124380,116751,15911,23540,-17213,-17213,-107719,100,34553,49647,11954,59.95542939,-7734,61669,-7734,0,1913,15927,-18199,58.93453672,706.75,972,562.25,35.26540574
WHEAT - KANSAS CITY BOARD OF TRADE,7/2/2013,001612,136680,36623,56464,36342,1498,2755,28355,34035,7403,4985,8299,3901,120364,114355,16316,22325,-19841,-18808,-107719,98.83816401,34844,49647,11954,60.72745603,-5680,61669,-5680,0,2418,15927,-18199,60.41434683,674,972,512.75,35.11159499
WHEAT - KANSAS CITY BOARD OF TRADE,6/25/2013,001612,133588,33633,57586,38116,1501,2502,26906,29686,5793,5428,9871,3369,115747,110308,17841,23280,-23953,-18808,-107719,94.21331444,36615,49647,11954,65.42594116,-2780,61669,-3972,1.815938209,365,15927,-18199,54.39840591,704.25,972,468.25,46.84863524
WHEAT - KANSAS CITY BOARD OF TRADE,6/18/2013,001612,135982,34408,57346,38750,1615,1669,27251,31223,4753,6696,11670,4342,117869,112618,18113,23364,-22938,-18808,-107719,95.35490547,37135,49647,11954,66.80550765,-3972,61669,-3972,0,-1943,15927,-18199,47.63523413,719.25,972,468.25,49.82630273
WHEAT - KANSAS CITY BOARD OF TRADE,6/11/2013,001612,135613,31085,63103,41547,2084,1371,27667,25484,4484,6542,11149,4657,117353,112332,18260,23281,-32018,-18808,-107719,85.14244582,39463,49647,11954,72.98172074,2183,61669,-3855,9.214944143,-2058,15927,-18199,47.29824767,730,972,468.25,51.96029777
WHEAT - KANSAS CITY BOARD OF TRADE,6/4/2013,001612,140702,27292,69172,44614,3267,1576,29928,21138,5270,6337,10622,6462,121479,117507,19223,23195,-41880,-18808,-107719,74.05045495,41347,49647,11954,77.97999629,8790,61669,-3855,19.29827239,-1067,15927,-18199,50.20219188,750.75,972,462,56.61764706
WHEAT - KANSAS CITY BOARD OF TRADE,5/28/2013,001612,142220,28314,71386,45017,3149,1471,30939,20727,6387,6048,10205,6344,124520,119669,17700,22551,-43072,-18808,-107719,72.70978844,41868,49647,11954,79.3622158,10212,61669,-3855,21.46846957,339,15927,-18199,54.32221766,743.5,972,462,55.19607843
WHEAT - KANSAS CITY BOARD OF TRADE,5/21/2013,001612,139251,28521,71757,46056,2974,1651,29865,20261,4115,6098,9701,5594,121900,116053,17351,23198,-43236,-18808,-107719,72.52533432,43082,49647,11954,82.58297297,9604,61669,-3855,20.54056529,-1983,15927,-18199,47.51802145,738.5,972,462,54.21568627
WHEAT - KANSAS CITY BOARD OF TRADE,5/14/2013,001612,136751,26338,73178,46067,3184,1897,30579,15055,5043,5784,12733,3854,119562,114944,17189,21807,-46840,-18808,-107719,68.47184263,42883,49647,11954,82.05502348,15524,61669,-3855,29.57542275,-741,15927,-18199,51.15747524,760,972,462,58.43137255
WHEAT - KANSAS CITY BOARD OF TRADE,5/7/2013,001612,135725,26167,73235,46586,3416,1387,29009,14134,6409,5263,12203,3665,118486,114449,17239,21276,-47068,-18808,-107719,68.21540642,43170,49647,11954,82.81643807,14875,61669,-3855,28.58494597,1146,15927,-18199,56.68698353,769.75,972,462,60.34313725
WHEAT - KANSAS CITY BOARD OF TRADE,4/30/2013,001612,141362,27486,73979,48412,3184,1602,32994,20353,5722,5212,11525,4005,125433,120370,15929,20992,-46493,-18808,-107719,68.86212055,45228,49647,11954,88.27633778,12641,61669,-3855,25.17550821,510,15927,-18199,54.82330188,798,972,462,65.88235294
WHEAT - KANSAS CITY BOARD OF TRADE,4/23/2013,001612,151704,34840,72878,46730,3149,3394,30160,25827,7766,6508,11082,5133,134531,129229,17173,22475,-38038,-18808,-107719,78.37163006,43581,49647,11954,83.9068262,4333,61669,-3855,12.4961846,1258,15927,-18199,57.01517904,737.25,972,462,53.97058824
WHEAT - KANSAS CITY BOARD OF TRADE,4/16/2013,001612,155373,36923,75641,46427,3193,3616,30189,27616,9909,6271,7099,5101,138436,132175,16937,23198,-38718,-18808,-107719,77.6068203,43234,49647,11954,82.98623087,2573,61669,-3855,9.810145901,3638,15927,-18199,63.98933365,741.75,972,462,54.85294118
WHEAT - KANSAS CITY BOARD OF TRADE,4/9/2013,001612,157478,33791,73712,46301,3236,3171,28864,24665,14031,6537,6687,6027,138722,131529,18756,25949,-39921,-18808,-107719,76.25378187,43065,49647,11954,82.53787175,4199,61669,-3855,12.29167938,7494,15927,-18199,75.28863623,746.5,972,462,55.78431373
WHEAT - KANSAS CITY BOARD OF TRADE,4/2/2013,001612,158589,30873,72807,46996,3409,2993,29784,27339,14885,10429,7132,5246,141206,133811,17383,24778,-41934,-18808,-107719,73.98972006,43587,49647,11954,83.92274428,2445,61669,-3855,9.614797631,4456,15927,-18199,66.386333,716.75,972,462,49.95098039
WHEAT - KANSAS CITY BOARD OF TRADE,3/26/2013,001612,167247,33112,72439,46970,3451,3746,30841,27875,17262,10115,9876,6361,148407,141010,18840,26237,-39327,-18808,-107719,76.92186569,43519,49647,11954,83.74233943,2966,61669,-3855,10.40992613,7147,15927,-18199,74.27181621,768.5,972,462,60.09803922
WHEAT - KANSAS CITY BOARD OF TRADE,3/19/2013,001612,167590,32713,69990,47999,4837,5759,31349,29681,16393,10157,10558,5206,149576,142424,18014,25166,-37277,-18808,-107719,79.22754215,43162,49647,11954,82.79521397,1668,61669,-3855,8.42897259,6236,15927,-18199,71.60229737,751.75,972,462,56.81372549
WHEAT - KANSAS CITY BOARD OF TRADE,3/12/2013,001612,164392,32032,67252,49103,5412,5235,30544,30543,16064,9329,10935,5364,147671,140805,16721,23587,-35220,-18808,-107719,81.54109165,43691,49647,11954,84.19865758,1,61669,-3855,5.884866614,6735,15927,-18199,73.06452558,735,972,462,53.52941176
WHEAT - KANSAS CITY BOARD OF TRADE,3/5/2013,001612,164037,31844,69757,49434,4251,5232,29604,27760,18377,9257,10745,4189,147937,140311,16100,23726,-37913,-18808,-107719,78.51222009,45183,49647,11954,88.15695222,1844,61669,-3855,8.697576461,9120,15927,-18199,80.05333177,736.25,972,462,53.7745098
WHEAT - KANSAS CITY BOARD OF TRADE,2/26/2013,001612,172805,41395,79265,47855,4340,6899,29042,27288,19510,8947,8789,2104,155752,148195,17053,24610,-37870,-18808,-107719,78.56058305,43515,49647,11954,83.73172738,1754,61669,-3855,8.560222209,10563,15927,-18199,84.28177929,732.75,972,462,53.08823529
WHEAT - KANSAS CITY BOARD OF TRADE,2/19/2013,001612,186748,41838,84479,48939,4013,7243,28785,24604,24801,10668,9435,3353,165627,157928,21121,28820,-42641,-18808,-107719,73.19454286,44926,49647,11954,87.47512801,4181,61669,-3855,12.26420853,14133,15927,-18199,94.74301119,769,972,462,60.19607843
WHEAT - KANSAS CITY BOARD OF TRADE,2/12/2013,001612,187813,40388,86980,50863,3423,6824,31386,22034,23349,7422,9839,5788,166020,158237,21793,29576,-46592,-18808,-107719,68.75077325,47440,49647,11954,94.14480142,9352,61669,-3855,20.15597338,15927,15927,-18199,100,778,972,462,61.96078431
WHEAT - KANSAS CITY BOARD OF TRADE,2/5/2013,001612,186194,37172,89163,52860,3213,8176,31848,21240,22199,7202,10099,4517,163974,158607,22220,27587,-51991,-18808,-107719,62.67840875,49647,49647,11954,100,10608,61669,-3855,22.07282828,14997,14997,-18199,100,807.25,972,462,67.69607843
WHEAT - KANSAS CITY BOARD OF TRADE,1/29/2013,001612,182164,38859,93283,51004,3255,7476,32738,17518,20779,6718,8930,4323,161897,155564,20267,26600,-54424,-18808,-107719,59.94196444,47749,47966,11954,99.39742308,15220,61669,-3855,29.11147061,14061,14125,-18199,99.8020047,830.75,972,462,72.30392157
WHEAT - KANSAS CITY BOARD OF TRADE,1/22/2013,001612,177330,37777,92874,50075,2109,7685,32141,15288,19595,5908,9047,3748,156929,150346,20401,26984,-55097,-18808,-107719,59.18502772,47966,47966,11954,100,16853,61669,-3855,31.6036872,13687,14125,-18199,98.64496968,830.75,972,462,72.30392157
WHEAT - KANSAS CITY BOARD OF TRADE,1/15/2013,001612,175418,36748,89596,48926,1387,7589,33013,14487,19767,5642,9593,3661,155346,146080,20072,29338,-52848,-18808,-107719,61.71452351,47539,47539,11954,100,18526,61669,-3855,34.15695013,14125,14125,-18199,100,838.25,972,462,73.7745098
WHEAT - KANSAS CITY BOARD OF TRADE,1/8/2013,001612,162698,41569,88456,37802,1337,5542,28796,11916,16775,9925,9217,2675,143084,135918,19614,26780,-46887,-18808,-107719,68.41898078,36465,39562,11954,88.78223703,16880,61669,-3855,31.64489347,6850,10101,-18199,88.51236749,808.75,972,462,67.99019608
WHEAT - KANSAS CITY BOARD OF TRADE,12/31/2012,001612,158401,40845,91630,38239,1777,4794,28348,6520,16822,8961,10139,2531,140540,134213,17861,24188,-50785,-18808,-107719,64.03482134,36462,39562,11954,88.77137062,21828,61669,-3855,39.19632501,7861,10101,-18199,92.08480565,831,972,462,72.35294118
WHEAT - KANSAS CITY BOARD OF TRADE,12/24/2012,001612,155602,38667,92247,38083,1882,5516,29182,5563,15606,8761,9831,2292,138107,132937,17495,22665,-53580,-18808,-107719,60.89122831,36201,39562,11954,87.82599247,23619,61669,-3855,41.92967462,6845,10101,-18199,88.49469965,844.5,972,462,75
WHEAT - KANSAS CITY BOARD OF TRADE,12/18/2012,001612,157525,36337,93989,38436,2913,5165,32310,5848,14156,9358,10009,2967,138729,135047,18796,22478,-57652,-18808,-107719,56.31136755,35523,39562,11954,85.37018256,26462,61669,-3855,46.26854282,4798,10101,-18199,81.2614841,860.5,972,462,78.1372549
WHEAT - KANSAS CITY BOARD OF TRADE,12/11/2012,001612,157194,26444,94497,39672,2477,4639,40375,3733,14887,8611,9150,4053,138681,133436,18513,23758,-68053,-18808,-107719,44.61315248,37195,39562,11954,91.42639815,36642,61669,-3855,61.80483487,6276,10101,-18199,86.48409894,868.75,972,462,79.75490196
WHEAT - KANSAS CITY BOARD OF TRADE,12/4/2012,001612,162902,25869,99556,37700,2490,5022,45195,3870,16158,8654,9613,4516,143114,141225,19788,21677,-73687,-18808,-107719,38.27647873,35210,39562,11954,84.2364532,41325,61669,-3855,68.95183444,7504,10101,-18199,90.82332155,887.75,972,462,83.48039216
WHEAT - KANSAS CITY BOARD OF TRADE,11/27/2012,001612,173713,29895,104269,40475,3538,5087,46285,6137,16445,8336,9826,4905,151428,150207,22285,23506,-74374,-18808,-107719,37.50379593,36937,39562,11954,90.49188641,40148,61669,-3855,67.15554606,8109,10101,-18199,92.96113074,915.75,972,462,88.97058824
WHEAT - KANSAS CITY BOARD OF TRADE,11/20/2012,001612,165677,25836,101011,39541,3200,4322,47190,6424,14577,8423,9505,4591,144480,143630,21197,22047,-75175,-18808,-107719,36.60289503,36341,39562,11954,88.33309186,40766,61669,-3855,68.09871192,6154,10101,-18199,86.05300353,877.5,972,462,81.47058824
WHEAT - KANSAS CITY BOARD OF TRADE,11/13/2012,001612,170650,25289,107370,40877,5040,2926,51485,4552,13868,11665,9862,3994,150104,147612,20546,23038,-82081,-18808,-107719,28.83557715,35837,39562,11954,86.50753405,46933,61669,-3855,77.51053049,2203,10101,-18199,72.09187279,887.75,972,462,83.48039216
WHEAT - KANSAS CITY BOARD OF TRADE,11/6/2012,001612,170018,24876,109395,43104,4783,3264,53240,4114,13724,11102,10364,2176,151486,147820,18532,22198,-84519,-18808,-107719,26.09350924,38321,39562,11954,95.50492611,49126,61669,-3855,80.85739576,2622,10101,-18199,73.57243816,919.5,972,462,89.70588235
WHEAT - KANSAS CITY BOARD OF TRADE,10/30/2012,001612,163034,22204,106847,41442,4120,2387,52991,1341,13365,9452,10475,3105,144946,141640,18088,21394,-84643,-18808,-107719,25.95404393,37322,39562,11954,91.88640974,51650,61669,-3855,84.70941945,3913,10101,-18199,78.13427562,909.25,972,462,87.69607843
WHEAT - KANSAS CITY BOARD OF TRADE,10/23/2012,001612,161326,26706,108378,41047,3525,1861,50501,1111,12814,8682,10696,2469,144080,140854,17246,20472,-81672,-18808,-107719,29.29558772,37522,39562,11954,92.61083744,49390,61669,-3855,81.26030157,4132,10101,-18199,78.90812721,907.75,972,462,87.40196078
WHEAT - KANSAS CITY BOARD OF TRADE,10/16/2012,001612,158180,27226,105880,40933,3413,1921,46462,1090,12665,9134,10896,1889,140230,137754,17950,20426,-78654,-18808,-107719,32.68999336,37520,39562,11954,92.60359316,45372,61669,-3855,75.1281973,3531,10101,-18199,76.7844523,882.75,972,462,82.5
WHEAT - KANSAS CITY BOARD OF TRADE,10/9/2012,001612,157240,27249,104636,41072,3285,2275,45174,1000,13703,8306,9986,1627,139406,136512,17834,20728,-77387,-18808,-107719,34.11501389,37787,39562,11954,93.57070414,44174,61669,-3855,73.29985959,5397,10101,-18199,83.37809187,888.75,972,462,83.67647059
WHEAT - KANSAS CITY BOARD OF TRADE,10/2/2012,001612,159279,27163,108462,42718,3156,2455,45415,0,12203,8113,10206,1925,139992,138407,19287,20872,-81299,-18808,-107719,29.71510837,39562,39562,11954,100,45415,61669,-3855,75.19382211,4090,10101,-18199,78.75971731,892.25,972,462,84.3627451
WHEAT - KANSAS CITY BOARD OF TRADE,9/25/2012,001612,160235,25297,109182,43471,3962,2138,49611,0,12012,7473,10661,1789,141791,139744,18444,20491,-83885,-18808,-107719,26.80658186,39509,39509,11954,100,49611,61669,-3855,81.59758257,4539,10101,-18199,80.34628975,911,972,462,88.03921569
WHEAT - KANSAS CITY BOARD OF TRADE,9/18/2012,001612,154794,23669,102671,37557,4503,1731,51626,0,11325,9243,11137,1736,136887,133103,17907,21691,-79002,-18808,-107719,32.29859073,33054,35693,11954,88.88327225,51626,61669,-3855,84.67279165,2082,10101,-18199,71.66431095,889,972,462,83.7254902
WHEAT - KANSAS CITY BOARD OF TRADE,9/11/2012,001612,148758,24439,96827,33157,5252,1605,48864,0,10745,9112,11542,1773,129695,127744,19063,21014,-72388,-18808,-107719,39.7374903,27905,35693,11954,67.19322634,48864,61669,-3855,80.45754227,1633,10101,-18199,70.07773852,884,972,462,82.74509804
WHEAT - KANSAS CITY BOARD OF TRADE,9/4/2012,001612,146996,26363,95504,33354,5588,1940,46311,0,9440,10702,11853,1501,129611,125826,17385,21170,-69141,-18808,-107719,43.38945687,27766,35693,11954,66.60769198,46311,61669,-3855,76.56126,-1262,10101,-18199,59.84805654,881.25,972,462,82.20588235
WHEAT - KANSAS CITY BOARD OF TRADE,8/28/2012,001612,149480,27276,99119,33801,3183,2129,43468,33,10033,10468,9084,2463,129638,126044,19842,23436,-71843,-18808,-107719,40.35046282,30618,35693,11954,78.62167741,43435,61669,-3855,72.17202857,-435,10101,-18199,62.77031802,867.5,972,462,79.50980392
WHEAT - KANSAS CITY BOARD OF TRADE,8/21/2012,001612,154981,29178,102294,33484,2846,2296,44265,0,10054,10140,9986,2705,132122,130181,22859,24800,-73116,-18808,-107719,38.91869397,30638,35693,11954,78.70592696,44265,61669,-3855,73.43874,-86,10101,-18199,64.00353357,908.25,972,462,87.5
WHEAT - KANSAS CITY BOARD OF TRADE,8/14/2012,001612,156814,29325,99235,32914,2894,2592,41331,90,10416,12164,9509,3834,132576,128570,24238,28244,-69910,-18808,-107719,42.52454702,30020,35693,11954,76.10261595,41241,61669,-3855,68.82363714,-1748,10101,-18199,58.13074205,852,972,462,76.47058824
WHEAT - KANSAS CITY BOARD OF TRADE,8/7/2012,001612,156676,30211,100594,33566,2912,3703,41354,170,9900,11436,9867,2461,132631,129607,24045,27069,-70383,-18808,-107719,41.99255435,30654,35693,11954,78.77332659,41184,61669,-3855,68.73664611,-1536,10101,-18199,58.87985866,896,972,462,85.09803922
WHEAT - KANSAS CITY BOARD OF TRADE,7/31/2012,001612,160052,31948,100402,35608,3228,4081,42131,752,9804,10958,10802,2497,137027,131566,23025,28486,-68454,-18808,-107719,44.16213967,32380,35693,11954,86.04406251,41379,61669,-3855,69.03424699,-1154,10101,-18199,60.22968198,892.5,972,462,84.41176471
WHEAT - KANSAS CITY BOARD OF TRADE,7/24/2012,001612,161503,32961,102428,35704,3163,4813,41934,1616,9507,10357,8872,2401,137677,132800,23826,28703,-69467,-18808,-107719,43.02279808,32541,35693,11954,86.72227137,40318,61669,-3855,67.41499298,-850,10101,-18199,61.30388693,880.5,972,462,82.05882353
WHEAT - KANSAS CITY BOARD OF TRADE,7/17/2012,001612,156948,28428,101090,36751,2847,5376,43489,2365,7873,10923,9714,4593,137433,133858,19515,23090,-72662,-18808,-107719,39.42931696,33904,35693,11954,92.46387801,41124,61669,-3855,68.64507661,-3050,10101,-18199,53.53003534,893,972,462,84.50980392
WHEAT - KANSAS CITY BOARD OF TRADE,7/10/2012,001612,150095,26423,94133,35437,2189,5900,39859,3849,7658,9734,8390,5534,130545,127653,19550,22442,-67710,-18808,-107719,44.99893152,33248,35693,11954,89.70049286,36010,61669,-3855,60.84030279,-2076,10101,-18199,56.97173145,812,972,462,68.62745098
WHEAT - KANSAS CITY BOARD OF TRADE,7/3/2012,001612,145874,26537,89221,34264,2034,5945,38783,5274,8307,9719,7656,5258,128813,123695,17061,22179,-62684,-18808,-107719,50.65177537,32230,35693,11954,85.41219091,33509,61669,-3855,57.02338075,-1412,10101,-18199,59.3180212,785,972,462,63.33333333
WHEAT - KANSAS CITY BOARD OF TRADE,6/26/2012,001612,146047,31870,86397,34539,1951,4880,36559,9274,7648,9301,7495,3868,128665,121513,17382,24534,-54527,-18808,-107719,59.82611825,32588,35693,11954,86.9202578,27285,61669,-3855,47.52457115,-1653,10101,-18199,58.4664311,735.75,972,462,53.67647059
WHEAT - KANSAS CITY BOARD OF TRADE,6/19/2012,001612,158040,35406,75392,34761,1940,4431,34047,16374,10088,8089,9189,4582,131404,121996,26636,36044,-39986,-18808,-107719,76.18067506,32821,35693,11954,87.90176503,17673,61669,-3855,32.85513705,1999,10101,-18199,71.37102473,670,972,462,40.78431373
WHEAT - KANSAS CITY BOARD OF TRADE,6/12/2012,001612,153461,32744,70563,35668,1930,3903,30096,15863,12392,7421,8527,6541,128765,119719,24696,33742,-37819,-18808,-107719,78.61794379,33738,35693,11954,91.76460677,14233,61669,-3855,27.60515231,4971,10101,-18199,81.87279152,640.75,972,462,35.04901961
WHEAT - KANSAS CITY BOARD OF TRADE,6/5/2012,001612,148612,31971,69813,35631,1928,4850,29472,15654,13755,7887,8230,3702,127268,117932,21344,30680,-37842,-18808,-107719,78.59207522,33703,35693,11871,91.6463773,13818,61669,-3855,26.97179659,5868,10101,-18199,85.04240283,638,972,462,34.50980392
WHEAT - KANSAS CITY BOARD OF TRADE,5/29/2012,001612,138459,31509,67911,34220,1928,5008,27745,13866,11317,8485,8085,3079,121363,111194,17096,27265,-36402,-18808,-107719,80.21167235,32292,35693,11871,85.723281,13879,61669,-3855,27.06489225,2832,10101,-18199,74.31448763,678,972,462,42.35294118
WHEAT - KANSAS CITY BOARD OF TRADE,5/22/2012,001612,137550,34200,65873,33571,1981,4472,28030,17495,10884,7904,8182,3253,122314,112140,15236,25410,-31673,-18808,-107719,85.53047429,31590,35693,11871,82.77642515,10535,61669,-3855,21.96141872,2980,10101,-18199,74.83745583,701.5,972,462,46.96078431
WHEAT - KANSAS CITY BOARD OF TRADE,5/15/2012,001612,144856,38208,60655,32492,1995,4467,30401,30425,10073,9780,7447,2315,127736,117377,17120,27479,-22447,-18808,-107719,95.9071431,30497,35693,11871,78.18822937,-24,61669,-3855,5.846712655,293,10101,-18199,65.34275618,627.5,972,462,32.45098039
WHEAT - KANSAS CITY BOARD OF TRADE,5/8/2012,001612,142267,36046,58981,32617,1968,4636,30893,29921,9947,9593,7655,2186,125918,115294,16349,26973,-22935,-18808,-107719,95.35827963,30649,35693,11871,78.82629502,972,61669,-3855,7.366766376,354,10101,-18199,65.55830389,625,972,462,31.96078431
WHEAT - KANSAS CITY BOARD OF TRADE,5/1/2012,001612,136118,34039,55147,32897,1974,4955,27562,28309,9725,9950,7575,2603,121731,110288,14387,25830,-21108,-18808,-107719,97.41314348,30923,35693,11871,79.97649232,-747,61669,-3855,4.743300165,-225,10101,-18199,63.51236749,645.5,972,462,35.98039216
WHEAT - KANSAS CITY BOARD OF TRADE,4/24/2012,001612,143211,38688,57496,31887,2101,4652,25048,27745,13338,9432,7425,3592,126637,116349,16574,26862,-18808,-16881,-107719,97.8786411,29786,35693,11871,75.20359332,-2697,61669,-3855,1.767291374,3906,10101,-18199,78.10954064,633,972,462,33.52941176
WHEAT - KANSAS CITY BOARD OF TRADE,4/17/2012,001612,147024,39988,61938,31132,2098,4784,26311,27806,13450,10206,5739,4511,130382,120326,16642,26698,-21950,-16881,-107719,94.41973623,29034,35693,11821,72.10539544,-1495,61669,-3855,3.601733716,3244,10101,-18199,75.77031802,632,972,462,33.33333333
WHEAT - KANSAS CITY BOARD OF TRADE,4/10/2012,001612,146548,35811,62383,31917,0,4162,27048,26375,14780,10162,5867,4455,128335,118022,18213,28526,-26572,-16881,-107719,89.33155728,31917,35693,11821,84.18230563,673,61669,-3855,6.910445028,4618,10101,-18199,80.6254417,641,972,462,35.09803922
WHEAT - KANSAS CITY BOARD OF TRADE,4/3/2012,001612,142998,34700,65989,32050,0,3460,27336,21063,14429,9245,6854,3423,124643,115218,18355,27780,-31289,-16881,-107719,84.13879654,32050,35693,11821,84.7394437,6273,61669,-3855,15.45693181,5184,10101,-18199,82.6254417,690,972,462,44.70588235
WHEAT - KANSAS CITY BOARD OF TRADE,3/27/2012,001612,134423,30259,65012,31322,0,4425,27114,16210,12642,8583,6792,3128,117473,108209,16950,26214,-34753,-16881,-107719,80.32541447,31322,35693,11821,81.68984584,10904,61669,-3855,22.52457115,4059,10101,-18199,78.65017668,679,972,462,42.54901961
WHEAT - KANSAS CITY BOARD OF TRADE,3/20/2012,001612,132771,28713,63403,27345,0,2772,26736,16054,12858,8709,6948,3330,110463,105365,22308,27406,-34690,-16881,-107719,80.39476871,27345,35693,11821,65.03016086,10682,61669,-3855,22.18576399,4149,10101,-18199,78.96819788,680.5,972,462,42.84313725
WHEAT - KANSAS CITY BOARD OF TRADE,3/13/2012,001612,131418,27366,61798,31030,0,4424,26783,17396,11458,8020,6947,3455,112536,105478,18882,25940,-34432,-16881,-107719,80.67879081,31030,35693,11821,80.4666555,9387,61669,-3855,20.20938893,3438,10101,-18199,76.45583039,685,972,462,43.7254902
WHEAT - KANSAS CITY BOARD OF TRADE,3/6/2012,001612,127609,28779,65799,29559,0,3904,25871,13032,11490,9184,6287,3341,112128,103853,15481,23756,-37020,-15510,-107719,76.67255908,29559,35693,11821,74.30462466,12839,61669,-3855,25.47768756,2306,10101,-18199,72.45583039,687.5,972,462,44.21568627
WHEAT - KANSAS CITY BOARD OF TRADE,2/28/2012,001612,132029,31260,66655,29644,0,3686,26750,16693,11450,8730,5935,4084,115604,108503,16425,23526,-35395,-12809,-107719,76.20271836,29644,35693,11821,74.66069035,10057,61669,-3855,21.23191502,2720,10101,-18199,73.91872792,699.5,972,462,46.56862745
WHEAT - KANSAS CITY BOARD OF TRADE,2/21/2012,001612,141386,34960,72222,30396,0,4035,27006,15704,15268,8167,5008,4344,124176,116581,17210,24805,-37262,-12809,-107719,74.23559161,30396,35693,11821,77.8108244,11302,61669,-3855,23.13198217,7101,10101,-18199,89.39929329,677,972,462,42.15686275
WHEAT - KANSAS CITY BOARD OF TRADE,2/14/2012,001612,143382,35053,75128,29431,0,4104,27502,12783,16112,8731,4353,4349,125282,116829,18100,26553,-40075,-12809,-107719,71.27173111,29431,35693,11821,73.76843164,14719,61669,-3855,28.34686527,7381,10101,-18199,90.38869258,675.5,972,462,41.8627451
WHEAT - KANSAS CITY BOARD OF TRADE,2/7/2012,001612,147263,34263,79520,29526,0,5835,28586,10260,18355,8421,4388,4251,129237,122609,18026,24654,-45257,-12809,-107719,65.81182173,29526,35693,11821,74.1663874,18326,61669,-3855,33.85171845,9934,10101,-18199,99.40989399,712,972,462,49.01960784
WHEAT - KANSAS CITY BOARD OF TRADE,1/31/2012,001612,146854,35331,76651,29518,0,5225,26897,14102,17483,8764,3787,4342,127560,121590,19294,25264,-41320,-12809,-107719,69.95996207,29518,35693,11821,74.13287534,12795,61669,-3855,25.4105366,8719,10101,-18199,95.11660777,715.5,972,462,49.70588235
WHEAT - KANSAS CITY BOARD OF TRADE,1/24/2012,001612,145942,34358,70423,28499,0,4161,24938,19768,19358,11135,3330,4847,127296,121887,18646,24055,-36065,-12809,-107719,75.49678643,28499,35693,11821,69.86427614,5170,61669,-3855,13.77357915,8223,10101,-18199,93.3639576,686,972,462,43.92156863
WHEAT - KANSAS CITY BOARD OF TRADE,1/17/2012,001612,141914,31877,71170,27401,0,3547,26640,15978,20021,10693,3687,4355,124534,118758,17380,23156,-39293,-12809,-107719,72.09566958,27401,35693,11821,65.26474531,10662,61669,-3855,22.15524083,9328,10101,-18199,97.26855124,673,972,462,41.37254902
WHEAT - KANSAS CITY BOARD OF TRADE,1/10/2012,001612,142039,32207,73879,25903,0,3132,26475,13252,21672,11571,3526,3095,124055,118556,17984,23483,-41672,-12809,-107719,69.5890844,25903,35693,11821,58.98961126,13223,61669,-3855,26.06373237,10101,10101,-18199,100,698,972,462,46.2745098
WHEAT - KANSAS CITY BOARD OF TRADE,1/3/2012,001612,139302,30101,70984,24684,0,3324,28058,14074,21197,11616,3427,2512,121492,115518,17810,23784,-40883,-12809,-107719,70.42039827,24684,35693,11821,53.88321046,13984,61669,-3855,27.22513888,9581,9581,-18199,100,712.5,972,462,49.11764706
WHEAT - KANSAS CITY BOARD OF TRADE,12/27/2011,001612,137302,29700,66454,24209,0,2827,26799,17671,20722,12136,3089,3072,119465,113835,17837,23467,-36754,-12809,-107719,74.77083553,24209,35693,11821,51.89343164,9128,61669,-3855,19.81411391,8586,9177,-18199,97.84117475,695.75,972,462,45.83333333
WHEAT - KANSAS CITY BOARD OF TRADE,12/20/2011,001612,137492,29689,64141,24414,0,2679,27423,20785,19659,12960,2994,3350,120174,113608,17318,23884,-34452,-12809,-107719,77.19629122,24414,35693,11816,52.76207229,6638,61669,-3855,16.01397961,6699,9177,-18199,90.94827586,668,972,462,40.39215686
WHEAT - KANSAS CITY BOARD OF TRADE,12/13/2011,001612,137784,28101,63976,23613,0,2657,30791,21913,18739,13186,3309,3835,120922,114429,16862,23355,-35875,-12809,-107719,75.69697608,23613,35693,11369,50.33711561,8878,61669,-3855,19.43257432,5553,9177,-18199,86.76212741,649.75,972,462,36.81372549
WHEAT - KANSAS CITY BOARD OF TRADE,12/6/2011,001612,136635,29360,65013,23556,0,1581,30251,21788,17206,14403,3711,3775,120132,113074,16503,23561,-35653,-12809,-107719,75.93088189,23556,35693,11174,50.49961255,8463,61669,-3855,18.79921861,2803,9177,-18199,76.71683226,667,972,462,40.19607843
WHEAT - KANSAS CITY BOARD OF TRADE,11/29/2011,001612,134769,30564,64654,23344,0,1830,30872,21404,14654,11777,4011,4635,117676,111188,17093,23581,-34090,-12809,-107719,77.57770519,23344,35693,11174,49.63497696,9468,61669,-3855,20.33300775,2877,9177,-18199,76.98714202,656,972,462,38.03921569
WHEAT - KANSAS CITY BOARD OF TRADE,11/22/2011,001612,147341,35963,69452,22178,0,4124,31459,21621,14948,12625,4403,4793,126090,119341,21251,28000,-33489,-12809,-107719,78.21093668,22178,35693,10905,45.47765048,9838,61669,-3855,20.89768634,2323,9177,-18199,74.96347165,661,972,462,39.01960784
WHEAT - KANSAS CITY BOARD OF TRADE,11/15/2011,001612,157129,37586,75956,22871,0,4664,33462,20187,17329,12730,4225,5298,133940,127659,23189,29470,-38370,-12809,-107719,73.06816985,22871,35693,10550,49.00369884,13275,61669,-3855,26.14309261,4599,9177,-18199,83.2773232,705,972,462,47.64705882
WHEAT - KANSAS CITY BOARD OF TRADE,11/8/2011,001612,155152,33008,75184,22189,251,2813,32798,16694,18706,13433,4117,6506,129453,124271,25699,30881,-42176,-12809,-107719,69.058055,21938,35693,10066,46.3261404,16104,61669,-3855,30.46059459,5273,9177,-18199,85.73933372,738.5,972,462,54.21568627
WHEAT - KANSAS CITY BOARD OF TRADE,11/1/2011,001612,157730,32375,76088,22228,251,4452,33032,16883,21090,15505,3729,6093,134775,128586,22955,29144,-43713,-12433,-107719,67.17251223,21977,35693,10066,46.47832364,16149,61669,-3855,30.52927172,5585,9177,-18199,86.87901812,718.5,972,462,50.29411765
WHEAT - KANSAS CITY BOARD OF TRADE,10/25/2011,001612,154796,31587,76431,22334,251,3849,33357,16654,21431,15188,3780,4500,132246,126896,22550,27900,-44844,-11188,-107719,65.13451637,22083,35693,9802,47.43347109,16703,61669,-3855,31.37476345,6243,9177,-18199,89.28258328,733.5,972,462,53.23529412
WHEAT - KANSAS CITY BOARD OF TRADE,10/18/2011,001612,157132,31012,76888,22955,246,3198,36661,17993,22443,13327,3476,5397,134993,129641,22139,27491,-45876,-10706,-107719,63.74712667,22709,35693,9802,49.85129968,18668,61669,-3855,34.37366461,9116,9177,-18199,99.77717709,711.5,972,462,48.92156863
WHEAT - KANSAS CITY BOARD OF TRADE,10/11/2011,001612,157795,29886,77408,24790,245,3191,34463,16609,22281,14267,3449,6870,135748,130053,22047,27742,-47522,-10385,-107719,61.84580928,24545,35693,9802,56.94256692,17854,61669,-3855,33.13137171,8014,9177,-18199,95.75175336,729.75,972,462,52.5
WHEAT - KANSAS CITY BOARD OF TRADE,10/4/2011,001612,160762,29395,80662,22391,1,2517,40807,14910,21718,12541,3673,7606,136975,131087,23787,29675,-51267,-10385,-107719,57.99823289,22390,35693,9802,48.61921131,25897,61669,-3855,45.40626335,9177,9177,-18199,100,686.5,972,462,44.01960784
WHEAT - KANSAS CITY BOARD OF TRADE,9/27/2011,001612,158592,26574,87185,22045,39,2355,51026,13045,18110,11968,4199,5178,137256,130111,21336,28481,-60611,-10385,-107719,48.39829864,22006,35693,9802,47.13607045,37981,61669,-3855,63.84836091,6142,7491,-18199,94.74892954,753,972,462,57.05882353
WHEAT - KANSAS CITY BOARD OF TRADE,9/20/2011,001612,156971,25358,92619,24165,0,2107,52798,9121,16507,10964,5494,5562,137461,131410,19510,25561,-67261,-10385,-107719,41.56615366,24165,35693,9802,55.47487544,43677,61669,-3855,72.54135889,5543,7491,-18199,92.41728299,765,972,462,59.41176471
WHEAT - KANSAS CITY BOARD OF TRADE,9/13/2011,001612,154311,25763,99010,24483,0,1933,49209,4348,15320,13378,5349,3729,133815,129689,20496,24622,-73247,-10385,-107719,35.41619578,24483,35693,9802,56.70310146,44861,61669,-3855,74.34833038,1942,7491,-18199,78.4001557,777.5,972,462,61.8627451
WHEAT - KANSAS CITY BOARD OF TRADE,9/6/2011,001612,154282,23481,102736,25443,0,1686,49818,2385,15378,14886,5733,3509,134201,131427,20081,22855,-79255,-10385,-107719,29.24363532,25443,35693,9802,60.41095361,47433,61669,-3855,78.27360967,492,7491,-18199,72.75593616,846,972,462,75.29411765
WHEAT - KANSAS CITY BOARD OF TRADE,8/30/2011,001612,163888,27339,105249,25025,0,1479,49489,2421,16886,14502,6573,7215,141935,139823,21953,24065,-77910,-10385,-107719,30.62547517,25025,35693,9802,58.79649299,47068,61669,-3855,77.71656187,2384,7491,-18199,80.12066952,867.5,972,462,79.50980392
WHEAT - KANSAS CITY BOARD OF TRADE,8/23/2011,001612,171724,33967,108741,27257,528,2480,45175,5831,15231,16511,5320,7253,147874,145384,23850,26340,-74774,-10385,-107719,33.84737091,26729,35693,9802,65.37793056,39344,61669,-3855,65.92851474,-1280,7491,-18199,65.85831063,841,972,462,74.31372549
WHEAT - KANSAS CITY BOARD OF TRADE,8/16/2011,001612,171471,34027,107043,29660,526,2567,42273,5278,17468,15154,5120,8168,149317,146170,22154,25301,-73016,-10385,-107719,35.65352292,29134,35693,9802,74.66687266,36995,61669,-3855,62.34356877,2314,7491,-18199,79.84818996,817.5,972,462,69.70588235
WHEAT - KANSAS CITY BOARD OF TRADE,8/9/2011,001612,171699,34088,102520,30635,522,1374,43502,8849,17817,14173,5064,7376,148965,143522,22734,28177,-68432,-10385,-107719,40.3630797,30113,35693,9802,78.44810938,34653,61669,-3855,58.7693059,3644,7491,-18199,85.02530167,763,972,462,59.01960784
WHEAT - KANSAS CITY BOARD OF TRADE,8/2/2011,001612,170548,28088,98935,31377,522,4523,43958,8030,20293,13504,5078,7678,149421,145059,21127,25489,-70847,-10385,-107719,37.88193232,30855,35693,9802,81.31397011,35928,61669,-3855,60.7151578,6789,7491,-18199,97.26741923,808,972,462,67.84313725
WHEAT - KANSAS CITY BOARD OF TRADE,7/26/2011,001612,169877,32055,97800,30112,522,5503,41389,7378,20078,12587,4979,8208,149932,144468,19945,25409,-65745,-10385,-107719,43.12367724,29590,35693,9802,76.42810243,34011,61669,-3855,57.78951224,7491,7491,-18199,100,780.5,972,462,62.45098039
WHEAT - KANSAS CITY BOARD OF TRADE,7/19/2011,001612,166152,33922,95665,30924,524,5223,39174,8618,18618,11858,4693,7432,147151,140773,19001,25379,-61743,-10385,-107719,47.23529291,30400,35693,9802,79.55660268,30556,61669,-3855,52.51663513,6760,6764,-18199,99.98397628,778,972,462,61.96078431
WHEAT - KANSAS CITY BOARD OF TRADE,7/12/2011,001612,167288,38851,92559,29773,524,5998,34443,11079,15864,12492,4537,9148,146569,139709,20719,27579,-53708,-10385,-107719,55.49037335,29249,35693,9802,75.11104245,23364,61669,-3855,41.54050424,3372,6764,-18199,86.4118896,713.75,972,462,49.3627451
WHEAT - KANSAS CITY BOARD OF TRADE,7/5/2011,001612,165959,39031,95708,28697,518,5550,38117,9655,15377,10643,4570,8177,145592,139555,20367,26404,-56677,-10385,-107719,52.44005178,28179,35693,9802,70.97833224,28462,61669,-3855,49.32085953,4734,6764,-18199,91.86796459,718.5,972,462,50.29411765
WHEAT - KANSAS CITY BOARD OF TRADE,6/28/2011,001612,166241,38635,96956,28221,539,7016,40373,7688,13138,9411,4851,7365,144159,137553,22082,28688,-58321,-10385,-107719,50.75102225,27682,35693,9802,69.05874628,32685,61669,-3855,55.76582626,3727,6764,-18199,87.83399431,743.75,972,462,55.24509804
WHEAT - KANSAS CITY BOARD OF TRADE,6/21/2011,001612,171924,40221,100278,26762,2901,10161,43346,5172,10464,10103,4845,8439,149496,142260,22428,29664,-60057,-10385,-107719,48.96747283,23861,35693,9802,54.30072226,38174,61669,-3855,64.14290947,361,6764,-18199,74.35003806,803.5,972,462,66.96078431
WHEAT - KANSAS CITY BOARD OF TRADE,6/14/2011,001612,175749,39854,100783,26842,6812,10593,44644,5057,9458,11896,5842,8701,151988,147246,23761,28503,-60929,-10385,-107719,48.07158855,20030,35693,9802,39.50407478,39587,61669,-3855,66.29937122,-2438,6764,-18199,63.13744342,839.75,972,462,74.06862745
WHEAT - KANSAS CITY BOARD OF TRADE,6/7/2011,001612,182847,40902,104040,26807,6544,9564,44928,5318,10839,11722,5793,9036,153798,151134,29049,31713,-63138,-10385,-107719,45.80208355,20263,35693,9802,40.40400139,39610,61669,-3855,66.33447286,-883,6764,-18199,69.36666266,874.5,972,462,80.88235294
WHEAT - KANSAS CITY BOARD OF TRADE,5/31/2011,001612,179600,39340,107619,28659,6778,9195,46141,4729,10918,12351,6518,8090,154694,153847,24906,25753,-68279,-10385,-107719,40.52027041,21881,35693,9802,46.6532772,41412,61669,-3855,69.08461022,-1433,6764,-18199,67.16340183,908,972,462,87.45098039
WHEAT - KANSAS CITY BOARD OF TRADE,5/24/2011,001612,176141,38891,107619,28481,7119,8996,45992,4691,11558,11600,4093,6737,152255,150813,23886,25328,-68728,-10385,-107719,40.0589722,21362,35693,9802,44.64871963,41301,61669,-3855,68.91520664,-42,6764,-18199,72.73564876,912,972,462,88.23529412
WHEAT - KANSAS CITY BOARD OF TRADE,5/17/2011,001612,172979,39473,106412,27713,7699,9077,44363,5028,8377,13668,4546,7736,150407,148875,22572,24104,-66939,-10385,-107719,41.89697331,20014,35693,9802,39.44227724,39335,61669,-3855,65.91477932,-5291,6764,-18199,51.70852862,894.5,972,462,84.80392157
WHEAT - KANSAS CITY BOARD OF TRADE,5/10/2011,001612,175816,43742,108995,28268,7715,8534,43188,4113,8675,13818,6816,6006,152231,150854,23585,24962,-65253,-10385,-107719,43.62915322,20553,35693,9802,41.52408173,39075,61669,-3855,65.51797815,-5143,6764,-18199,52.30140608,932.5,972,462,92.25490196
WHEAT - KANSAS CITY BOARD OF TRADE,5/3/2011,001612,170792,39635,107686,30145,7350,6074,43576,3841,7442,13355,5980,6048,146275,144421,24517,26371,-68051,-10385,-107719,40.75451538,22795,35693,9802,50.18346143,39735,61669,-3855,66.52524266,-5913,6764,-18199,49.21684092,889,972,462,83.7254902
WHEAT - KANSAS CITY BOARD OF TRADE,4/26/2011,001612,186380,47200,116743,27518,7649,5526,46244,545,8748,13022,7391,12102,160360,158704,26020,27676,-69543,-10385,-107719,39.22164917,19869,35693,9802,38.88223707,45699,61669,-3855,75.62725108,-4274,6764,-18199,55.78255819,950.25,972,462,95.73529412
WHEAT - KANSAS CITY BOARD OF TRADE,4/19/2011,001612,193859,52677,118024,26443,7012,5798,43907,209,11594,11384,7458,13362,165165,163457,28694,30402,-65347,-10385,-107719,43.53257854,19431,35693,9802,37.19052953,43698,61669,-3855,72.57340822,210,6764,-18199,73.74514281,926,972,462,90.98039216
WHEAT - KANSAS CITY BOARD OF TRADE,4/12/2011,001612,198563,50773,119593,24981,7323,5931,49568,360,12655,11943,8272,13531,169382,167665,29181,30898,-68820,-10385,-107719,39.9644523,17658,35693,9802,30.34259009,49208,61669,-3855,80.98254075,712,6764,-18199,75.75611906,894,972,462,84.70588235
WHEAT - KANSAS CITY BOARD OF TRADE,4/5/2011,001612,191243,42617,117024,24253,7145,6392,50724,374,13674,15416,7818,12100,165176,164527,26067,26716,-74407,-10385,-107719,34.22442312,17108,35693,9802,28.2182998,50350,61669,-3855,82.72541359,-1742,6764,-18199,65.92556984,950,987,462,92.95238095
WHEAT - KANSAS CITY BOARD OF TRADE,3/29/2011,001612,181540,43938,108531,25963,6952,5726,43171,505,12733,14293,7004,11585,157409,153036,24131,28504,-64593,-10385,-107719,44.30723077,19011,35693,9802,35.56834421,42666,61669,-3855,70.9984128,-1560,6764,-18199,66.65464888,867,987,462,77.14285714
WHEAT - KANSAS CITY BOARD OF TRADE,3/22/2011,001612,181746,45398,107801,26450,7970,5702,42858,1218,13080,13544,7211,11622,158654,154604,23092,27142,-62403,-10385,-107719,46.55721536,18480,35693,9802,33.51743849,41640,61669,-3855,69.43257432,-464,6764,-18199,71.04514682,845,1119,462,58.29528158
WHEAT - KANSAS CITY BOARD OF TRADE,3/15/2011,001612,187373,46543,109911,24983,7666,5616,45451,827,14030,11895,7515,14200,162718,159765,24655,27608,-63368,-10385,-107719,45.5657838,17317,35693,9802,29.02553011,44624,61669,-3855,73.98663085,2135,6764,-18199,81.4565557,777,1213,462,41.94407457
WHEAT - KANSAS CITY BOARD OF TRADE,3/8/2011,001612,191892,44207,116832,23932,7478,4166,47676,1158,14803,10785,6546,12784,158353,163767,33539,28125,-72625,-10385,-107719,36.0552325,16454,35693,9802,25.69232552,46518,61669,-3855,76.87717478,4018,6764,-18199,88.99971958,864.5,1250,462,51.0786802
WHEAT - KANSAS CITY BOARD OF TRADE,3/1/2011,001612,195802,42470,118218,25356,7171,4199,47896,547,15889,12093,7109,14528,162431,167661,33371,28141,-75748,-10385,-107719,32.84669283,18185,35693,9802,32.37804643,47349,61669,-3855,78.14541237,3796,6764,-18199,88.1104034,902,1250,462,55.83756345
WHEAT - KANSAS CITY BOARD OF TRADE,2/22/2011,001612,210587,49462,125960,28155,7519,4854,48383,459,16836,13230,7593,15854,176774,179075,33813,31512,-76498,-10385,-107719,32.07615016,20636,35693,9802,41.84465644,47924,61669,-3855,79.02295342,3606,6764,-18199,87.34927693,872.75,1257.25,462,51.65042439
WHEAT - KANSAS CITY BOARD OF TRADE,2/15/2011,001612,212527,48424,130246,29240,7858,4704,48517,873,14674,17528,8510,12163,175250,179028,37277,33499,-81822,-10385,-107719,26.60632461,21382,35693,9802,44.72596655,47644,61669,-3855,78.59562908,-2854,6764,-18199,61.47097705,943.5,1257.25,462,60.5469978
WHEAT - KANSAS CITY BOARD OF TRADE,2/8/2011,001612,214887,49899,134017,29291,8003,4572,49210,612,16421,18352,8611,11360,179105,183596,35782,31291,-84118,-10385,-107719,24.24743666,21288,35693,9802,44.36290603,48598,61669,-3855,80.05158415,-1931,6764,-18199,65.1684493,972,1257.25,462,64.13077649
WHEAT - KANSAS CITY BOARD OF TRADE,2/1/2011,001612,215717,50218,136359,27822,8640,5902,50970,543,17196,17893,5249,11315,181316,185204,34401,30513,-86141,-10385,-107719,22.16902624,19182,35693,9802,36.22880538,50427,61669,-3855,82.84292778,-697,6764,-18199,70.11176541,924,1257.25,462,58.0949387
WHEAT - KANSAS CITY BOARD OF TRADE,1/25/2011,001612,212073,49701,132167,27646,9166,5818,49879,677,16990,18701,6196,9921,178656,180935,33417,31138,-82466,-10385,-107719,25.94468531,18480,35693,9802,33.51743849,49202,61669,-3855,80.9733838,-1711,6764,-18199,66.04975364,917.5,1257.25,462,57.27758566
WHEAT - KANSAS CITY BOARD OF TRADE,1/18/2011,001612,213352,50567,131426,27792,9126,5575,50070,990,18036,16152,6433,11079,179271,182665,34081,30687,-80859,-10385,-107719,27.5957014,18666,35693,9802,34.23583485,49080,61669,-3855,80.78719248,1884,6764,-18199,80.45106758,876.5,1257.25,462,52.12197422
WHEAT - KANSAS CITY BOARD OF TRADE,1/11/2011,001612,219533,58230,136487,27551,9004,5420,48419,890,17905,17731,6770,12511,187767,188987,31766,30546,-78257,-10385,-107719,30.26897076,18547,35693,9802,33.77621567,47529,61669,-3855,78.42012087,174,6764,-18199,73.60092938,838,1257.25,462,47.28072933
WHEAT - KANSAS CITY BOARD OF TRADE,1/4/2011,001612,221870,57268,138687,26508,9442,4422,49945,576,19896,20394,7228,11718,190151,191969,31719,29901,-81419,-10385,-107719,27.02036287,17066,35693,9802,28.05608126,49369,61669,-3855,81.22825224,-498,6764,-18199,70.90894524,849.25,1257.25,462,48.69537881
WHEAT - KANSAS CITY BOARD OF TRADE,12/28/2010,001612,218822,57564,138878,25777,9347,4635,49752,611,19866,20722,5561,10887,189203,189785,29619,29037,-81314,-10385,-107719,27.12823885,16430,35693,9802,25.59962921,49141,61669,-3855,80.88028814,-856,6764,-18199,69.47482274,860.5,1257.25,462,50.11002829
WHEAT - KANSAS CITY BOARD OF TRADE,12/21/2010,001612,217820,56974,137835,25543,8205,4575,48522,559,20277,21123,6251,11335,188349,189037,29471,28783,-80861,-10385,-107719,27.59364662,17338,35693,9802,29.10663937,47963,61669,-3855,79.0824736,-846,6764,-18199,69.51488203,826.5,1257.25,462,45.83464319
WHEAT - KANSAS CITY BOARD OF TRADE,12/14/2010,001612,217803,55334,135733,23813,8065,4344,50457,646,20740,22596,6539,11063,188347,187130,29456,30673,-80399,-10385,-107719,28.0683009,15748,35693,9802,22.96550925,49811,61669,-3855,81.90281424,-1856,6764,-18199,65.46889396,798.5,1257.25,462,42.31373782
WHEAT - KANSAS CITY BOARD OF TRADE,12/7/2010,001612,217945,53789,135325,22508,8228,4627,52775,1379,19947,25430,6699,11360,190436,187565,27509,30380,-81536,-10385,-107719,26.90015822,14280,35693,9802,17.29558534,51396,61669,-3855,84.32177523,-5483,6764,-18199,50.9393903,821.5,1257.25,462,45.20591009
WHEAT - KANSAS CITY BOARD OF TRADE,11/30/2010,001612,210781,50707,128561,23881,8801,4325,48224,1438,19398,25492,6053,12574,184601,181150,26180,29631,-77854,-10385,-107719,30.68300902,15080,35693,9802,20.38546213,46786,61669,-3855,77.28618521,-6094,6764,-18199,48.49176782,730,1257.25,462,33.70009431
WHEAT - KANSAS CITY BOARD OF TRADE,11/23/2010,001612,229888,61033,138129,23128,10438,6108,49388,1617,20323,26438,5934,15366,201784,197915,28104,31973,-77096,-10385,-107719,31.46177081,12690,35693,9802,11.15445522,47771,61669,-3855,78.78945119,-6115,6764,-18199,48.40764331,711.5,1257.25,462,31.37378183
WHEAT - KANSAS CITY BOARD OF TRADE,11/16/2010,001612,239671,57592,141080,22027,10073,7912,54814,1275,24342,26494,6388,15822,209003,206892,30668,32779,-83488,-10385,-107719,24.8946925,11954,35693,9802,8.311768568,53539,61669,-3855,87.59233258,-2152,6764,-18199,64.28313905,690,1257.25,462,28.67022949
WHEAT - KANSAS CITY BOARD OF TRADE,11/9/2010,001612,249053,52516,150232,26702,8546,5126,59524,1223,27743,29157,6594,11523,212291,210987,36762,38066,-97716,-10385,-107719,10.2769844,18156,35693,9802,32.26603839,58301,61669,-3855,94.85989866,-1414,6764,-18199,67.23951448,787,1257.25,462,40.86765168
WHEAT - KANSAS CITY BOARD OF TRADE,11/2/2010,001612,240739,48402,152469,29265,6170,3350,62434,765,26146,28437,6712,9821,207855,205433,32884,35306,-104067,-10385,-107719,3.752029096,23095,35693,9802,51.34216523,61669,61669,-3855,100,-2291,6764,-18199,63.72631495,748.5,1257.25,462,36.02640679
WHEAT - KANSAS CITY BOARD OF TRADE,10/26/2010,001612,233671,49996,150686,29445,6168,2814,61279,1290,23596,28909,6152,9353,205392,200059,28279,33612,-100690,-10385,-107719,7.22152588,23277,35693,9802,52.0451122,59989,59989,-3855,100,-5313,6764,-18199,51.62039819,738.5,1257.25,462,34.76894058
WHEAT - KANSAS CITY BOARD OF TRADE,10/19/2010,001612,225864,50544,147601,29219,6166,2696,59462,1141,19924,27664,6323,9528,199037,193379,26827,32485,-97057,-10385,-107719,10.95403456,23053,35693,9802,51.1799467,58321,59967,-3855,97.42095202,-7740,6764,-18199,41.89800905,715.5,1257.25,462,31.87676831
WHEAT - KANSAS CITY BOARD OF TRADE,10/12/2010,001612,221537,52087,148029,28805,6166,2824,58613,834,17047,26640,5963,6441,192457,187304,29080,34233,-95942,-10385,-107719,12.09957466,22639,35693,9802,49.58093546,57779,59967,-3855,96.57171508,-9593,6764,-18199,34.47502303,751,1257.25,462,36.34077334
WHEAT - KANSAS CITY BOARD OF TRADE,10/5/2010,001612,213832,49495,144724,30093,6347,2632,56799,1002,14165,26905,5717,6176,186265,180763,27567,33069,-95229,-10385,-107719,12.83210389,23746,35693,9802,53.85655247,55797,59967,-3855,93.46620288,-12740,6764,-18199,21.86836518,701,1257.25,462,30.05344231
WHEAT - KANSAS CITY BOARD OF TRADE,9/28/2010,001612,216856,48578,151038,30886,6170,2091,60063,622,12086,27085,5664,6526,187315,184197,29541,32659,-102460,-10385,-107719,5.403045185,24716,35693,9802,57.60302808,59441,59967,-3855,99.17583278,-14999,6764,-18199,12.81897208,716,1257.25,462,31.93964162
WHEAT - KANSAS CITY BOARD OF TRADE,9/21/2010,001612,213671,42904,150623,32662,6170,1502,60629,662,10126,28325,5850,6920,183068,181853,30603,31818,-107719,-10385,-107719,0,26492,35693,9802,64.46255456,59967,59967,-3855,100,-18199,6764,-18199,0,750,1257.25,462,36.21502672
WHEAT - KANSAS CITY BOARD OF TRADE,9/14/2010,001612,210309,42672,145715,33788,6130,1165,58780,862,9641,26961,6530,7823,180830,177866,29479,32443,-103043,-10385,-103043,0,27658,35693,9802,68.96604998,57918,57918,-3855,100,-17320,6764,-17320,0,759.75,1257.25,462,37.44105627
WHEAT - KANSAS CITY BOARD OF TRADE,9/7/2010,001612,203686,43190,141423,35250,7130,1227,55666,1694,8851,25241,5730,6699,176124,172754,27562,30932,-98233,-10385,-98233,0,28120,35693,9802,70.75045383,53972,53972,-3855,100,-16390,6764,-16390,0,738.75,1257.25,462,34.80037724
WHEAT - KANSAS CITY BOARD OF TRADE,8/31/2010,001612,201159,42134,137582,35437,7130,1231,54308,1260,8693,24062,5506,6675,172540,168077,28619,33082,-95448,-10385,-95448,0,28307,35693,9802,71.47271253,53048,53048,-3855,100,-15369,6764,-15369,0,687.75,1257.25,462,28.38729959
WHEAT - KANSAS CITY BOARD OF TRADE,8/24/2010,001612,206225,46402,139549,37992,6416,1301,49036,1704,9929,24778,4490,8734,178172,172123,28053,34102,-93147,-10385,-93147,0,31576,35693,9802,84.09872156,47332,47332,-3855,100,-14849,6764,-14849,0,700.75,1257.25,462,30.02200566
WHEAT - KANSAS CITY BOARD OF TRADE,8/17/2010,001612,210465,50457,138821,38610,6416,1086,46979,2190,9511,23404,5353,10405,180452,173782,30013,36683,-88364,-10385,-88364,0,32194,35693,9802,86.48565138,44789,45355,-3855,98.84982727,-13893,6764,-17008,13.10365135,677,1257.25,462,27.03552342
WHEAT - KANSAS CITY BOARD OF TRADE,8/10/2010,001612,209005,51274,136171,38328,5616,1587,47719,2364,8807,18631,6685,11856,178202,173086,30803,35919,-84897,-10385,-85528,0.839732244,32712,35693,9802,88.48634661,45355,45355,-3855,100,-9824,6764,-17008,30.22042739,712.5,1257.25,462,31.49952845
WHEAT - KANSAS CITY BOARD OF TRADE,8/3/2010,001612,201316,42786,127926,36336,4570,1559,48026,4923,10064,20983,6245,14353,174107,169640,27209,31676,-85140,-10385,-85528,0.516348828,31766,35693,9802,84.8325673,43103,43103,-3855,100,-10919,6764,-17008,25.61416793,685,1257.25,462,28.04149638
WHEAT - KANSAS CITY BOARD OF TRADE,7/27/2010,001612,191760,35741,121269,33345,159,710,45987,4368,18775,22092,5728,11604,168254,162613,23506,29147,-85528,-10385,-85528,0,33186,35693,9802,90.31709861,41619,41619,-3855,100,-3317,6764,-17008,57.59296652,615,1257.25,462,19.23923295
WHEAT - KANSAS CITY BOARD OF TRADE,7/20/2010,001612,181380,35889,109703,31688,284,673,39357,5930,19025,21424,5945,11372,159428,152932,21952,28448,-73814,-10385,-78690,7.138569651,31404,35693,9802,83.43439805,33427,37797,-3855,89.50830692,-2399,6764,-17008,61.45465253,589.5,1257.25,462,16.03269412
WHEAT - KANSAS CITY BOARD OF TRADE,7/13/2010,001612,175152,36194,95575,30219,284,773,33642,6931,19537,19433,7187,13192,152990,143479,22162,31673,-59381,-10385,-78690,28.26879438,29935,35693,9802,77.7606118,26711,37797,-3855,73.38423125,104,6764,-17008,71.98384654,562.25,1257.25,462,12.60609871
WHEAT - KANSAS CITY BOARD OF TRADE,7/6/2010,001612,169675,37868,79891,31142,743,583,29844,18223,19166,18465,6924,12332,149400,137862,20275,31813,-42023,-10385,-78690,53.68128248,30399,35693,9802,79.55274033,11621,37797,-3855,37.15547873,701,6764,-17008,74.49520444,512.75,1257.25,462,6.381640993
WHEAT - KANSAS CITY BOARD OF TRADE,6/29/2010,001612,157338,36386,71484,30767,967,501,27295,22594,14765,17839,6631,10625,138178,127567,19160,29771,-35098,-10385,-78690,63.81963253,29800,35693,9802,77.23919509,4701,37797,-3855,20.54163065,-3074,6764,-17008,58.61517752,468.25,1257.25,462,0.785916378
WHEAT - KANSAS CITY BOARD OF TRADE,6/22/2010,001612,168835,39131,72035,32252,1028,1091,27132,23325,15970,16623,7155,12960,145159,133564,23676,35271,-32904,-10385,-78690,67.03169607,31224,35693,9802,82.73917578,3807,37797,-3855,18.39527514,-653,6764,-17008,68.7994279,494,1257.25,462,4.023891858
WHEAT - KANSAS CITY BOARD OF TRADE,6/15/2010,001612,181150,49852,74458,32193,1160,958,27013,30868,16076,16353,6979,17887,160332,148386,20818,32764,-24606,-10385,-78690,79.18014787,31033,35693,9802,82.00146769,-3855,37797,-3855,0,-277,6764,-17008,70.38112065,478.25,1257.25,462,2.043382584
WHEAT - KANSAS CITY BOARD OF TRADE,6/8/2010,001612,179137,43975,72343,32676,750,1131,25682,28441,15336,16877,6763,19362,155039,144126,24098,35011,-28368,-10385,-78690,73.67249835,31926,35693,9802,85.45054266,-2759,37797,-3419,1.601319876,-1541,6764,-17008,65.06394077,462,1257.25,462,0
WHEAT - KANSAS CITY BOARD OF TRADE,6/1/2010,001612,164132,37111,71040,35494,695,1678,27848,24500,11907,14657,6671,17573,146268,134064,17864,30068,-33929,-10385,-78690,65.53107386,34799,35693,9802,96.54706269,3348,37797,-3419,16.41838121,-2750,6764,-17008,59.97812553,478,1257.25,465,1.640896182
WHEAT - KANSAS CITY BOARD OF TRADE,5/25/2010,001612,162204,37114,68493,35576,702,1643,27705,26749,11804,14533,7088,15943,144318,132422,17886,29782,-31379,-10385,-78690,69.26432911,34874,35693,9802,96.83673864,956,37797,-3419,10.61480978,-2729,6764,-17008,60.06646475,484.75,1257.25,465,2.492899968
WHEAT - KANSAS CITY BOARD OF TRADE,5/18/2010,001612,157556,36015,70672,35402,570,1554,27736,24088,11443,14265,7036,15579,141994,130942,15562,26614,-34657,-10385,-78690,64.46526609,34832,35693,9802,96.6745201,3648,37797,-3419,17.14625388,-2822,6764,-17008,59.67524819,488,1257.25,464.75,2.933753943
WHEAT - KANSAS CITY BOARD OF TRADE,5/11/2010,001612,153653,32729,74167,35504,489,1510,27912,18260,15443,12987,6080,11551,137636,127500,16017,26153,-41438,-10385,-78690,54.53773516,35015,35693,9802,97.38132942,9652,37797,-3419,31.71341227,2456,6764,-17008,81.87783948,502.5,1257.25,464.75,4.76340694
WHEAT - KANSAS CITY BOARD OF TRADE,5/4/2010,001612,150672,32277,72352,34896,498,849,27793,20291,15065,13452,5439,11371,135703,125865,14969,24807,-40075,-10385,-78690,56.53319669,34398,35693,9802,94.99826194,7502,37797,-3419,26.49699146,1613,6764,-17008,78.33165068,514,1257.25,464.75,6.214511041
WHEAT - KANSAS CITY BOARD OF TRADE,4/27/2010,001612,149276,33103,69899,34697,389,861,27347,21228,15654,12306,5337,9788,133756,123156,15520,26120,-36796,-10385,-78690,61.33372374,34308,35693,9802,94.65065081,6119,37797,-3419,23.14149845,3348,6764,-17008,85.63015312,492.5,1257.25,464.75,3.501577287
WHEAT - KANSAS CITY BOARD OF TRADE,4/20/2010,001612,154419,35244,69020,33785,428,2536,25592,24133,15647,13643,4859,9608,136055,126231,18364,28188,-33776,-10385,-78690,65.75506918,33357,35693,9802,90.97755977,1459,37797,-3419,11.83520963,2004,6764,-17008,79.97644287,501.75,1257.25,464.75,4.668769716
WHEAT - KANSAS CITY BOARD OF TRADE,4/13/2010,001612,154546,37255,66661,33983,634,2884,25368,28787,13676,13286,4901,9666,136118,127209,18428,27337,-29406,-10385,-78690,72.15284386,33349,35693,9802,90.946661,-3419,37797,-3419,0,390,6764,-17008,73.18694262,492.75,1257.25,464.75,3.533123028
WHEAT - KANSAS CITY BOARD OF TRADE,4/6/2010,001612,152913,38248,66011,33865,464,1743,25871,28498,15185,12140,5141,8704,135756,125746,17157,27167,-27763,-10385,-78690,74.55823146,33401,35693,9802,91.14750299,-2627,37797,-3172,1.33027411,3045,6764,-17008,84.35554434,481.5,1257.25,464.75,2.113564669
WHEAT - KANSAS CITY BOARD OF TRADE,3/30/2010,001612,148621,35632,66140,33264,184,1710,26107,29279,12802,14146,4384,8946,132607,123445,16014,25176,-30508,-10385,-78690,70.53949198,33080,35693,9802,89.90768993,-3172,37797,-3172,0,-1344,6764,-17008,65.89264681,479.5,1257.25,442.25,4.570552147
WHEAT - KANSAS CITY BOARD OF TRADE,3/23/2010,001612,141654,31633,65943,33253,170,1488,26560,23909,12526,13094,5516,7073,125627,116625,16027,25029,-34310,-10385,-78690,64.9732816,33083,35693,9802,89.91927697,2651,37797,-380,7.939335202,-568,6764,-17008,69.15699142,485,1257.25,442.25,5.245398773
WHEAT - KANSAS CITY BOARD OF TRADE,3/16/2010,001612,137798,29635,64601,33105,184,1463,26108,22071,12853,12224,4572,6592,121980,112336,15818,25462,-34966,-10385,-78690,64.01288339,32921,35693,9802,89.29357692,4037,37797,-380,11.56979333,629,6764,-17008,74.19232711,494.75,1257.25,442.25,6.441717791
WHEAT - KANSAS CITY BOARD OF TRADE,3/9/2010,001612,136837,30085,66176,33681,0,1321,26279,20846,12983,12266,4928,4818,121433,111072,15404,25765,-36091,-10385,-78690,62.36585901,33681,35693,9802,92.22895987,5433,37797,-380,15.22644524,717,6764,-17008,74.56251052,490.25,1257.25,442.25,5.889570552
WHEAT - KANSAS CITY BOARD OF TRADE,3/2/2010,001612,135949,30015,68158,33878,0,938,26580,19949,14192,12524,4724,3088,121215,111049,14734,24900,-38143,-10385,-78690,59.36168655,33878,35693,9802,92.98984203,6631,37797,-380,18.36446028,1668,6764,-17008,78.56301531,499,1257.25,442.25,6.963190184
WHEAT - KANSAS CITY BOARD OF TRADE,2/23/2010,001612,142712,32688,71636,34555,125,1958,26043,20323,14833,12360,4925,3429,125866,117229,16846,25483,-38948,-10385,-78690,58.18314911,34430,35693,9802,95.12185702,5720,37797,-380,15.97820677,2473,6764,-17008,81.94935218,498.25,1257.25,442.25,6.871165644
WHEAT - KANSAS CITY BOARD OF TRADE,2/16/2010,001612,147678,33256,71174,34459,0,3266,26244,19855,14784,11820,5722,4434,128263,119235,19415,28443,-37918,-10385,-78690,59.69109143,34459,35693,9802,95.23386505,6389,37797,-380,17.73057076,2964,6764,-17008,84.01480734,512.5,1257.25,442.25,8.619631902
WHEAT - KANSAS CITY BOARD OF TRADE,2/9/2010,001612,147294,32951,68747,34945,0,1967,26528,23188,15083,11493,4402,5485,128452,118872,18842,28422,-35796,-10385,-78690,62.79774541,34945,35693,9802,97.1109652,3340,37797,-380,9.744086754,3590,6764,-17008,86.6481575,490,1257.25,442.25,5.858895706
WHEAT - KANSAS CITY BOARD OF TRADE,2/2/2010,001612,148665,33925,72123,35693,0,2053,26185,18995,16342,9578,3970,6194,129970,119677,18695,28988,-38198,-10385,-78690,59.28116536,35693,35693,9802,100,7190,37797,-380,19.82869267,6764,6764,-17008,100,499,1257.25,442.25,6.963190184
WHEAT - KANSAS CITY BOARD OF TRADE,1/26/2010,001612,151085,32270,74236,35326,0,1839,28100,18286,16738,10411,3518,6163,130847,120780,20238,30305,-41966,-10385,-78690,53.76473172,35326,35538,9802,99.17625117,9814,37797,-380,26.70194096,6327,6327,-17008,100,499.5,1257.25,442.25,7.024539877
WHEAT - KANSAS CITY BOARD OF TRADE,1/19/2010,001612,148007,30058,76509,35535,0,1727,29773,15187,15194,9716,4738,6564,128567,119919,19440,28088,-46451,-10385,-78690,47.19859454,35535,35538,9802,99.98834318,14586,37797,-380,39.20161354,5478,5478,-17008,100,505,1257.25,442.25,7.699386503
WHEAT - KANSAS CITY BOARD OF TRADE,1/12/2010,001612,149056,31133,79513,35538,0,1716,28727,12636,13967,10283,5267,7849,129213,120948,19843,28108,-48380,-10385,-78690,44.37449674,35538,35538,9802,100,16091,37797,-380,43.14377767,3684,3684,-17008,100,534,1257.25,442.25,11.25766871
WHEAT - KANSAS CITY BOARD OF TRADE,1/5/2010,001612,144857,31461,77108,34071,0,1843,26862,15152,13752,10786,4003,7561,126336,119419,18521,25438,-45647,-10385,-78690,48.37566796,34071,34071,9802,100,11710,37797,-380,31.66828195,2966,3504,-17008,97.37714509,546.75,1257.25,442.25,12.82208589
WHEAT - KANSAS CITY BOARD OF TRADE,12/29/2009,001612,145598,33948,76366,33793,0,1961,26873,16942,12494,10800,4033,7917,127786,119713,17812,25885,-42418,-10385,-78690,53.10299392,33793,33793,9802,100,9931,37797,-380,27.0084082,1694,3504,-17008,91.17589704,538,1257.25,442.25,11.74846626
WHEAT - KANSAS CITY BOARD OF TRADE,12/22/2009,001612,142846,33793,74746,33594,0,1851,26365,16739,11663,11051,5277,8669,126986,118945,15860,23901,-40953,-10385,-78690,55.24778567,33594,33594,9802,100,9626,37797,-380,26.20949787,612,3504,-17008,85.90093604,517.25,1257.25,442.25,9.202453988
WHEAT - KANSAS CITY BOARD OF TRADE,12/15/2009,001612,139893,31894,76933,33460,0,1769,26560,12323,10800,11401,6974,6887,122771,115686,17122,24207,-45039,-10385,-78690,49.26579313,33460,33518,9802,99.75543937,14237,37797,-380,38.28745056,-601,3504,-17008,79.98732449,526.5,1257.25,442.25,10.33742331
WHEAT - KANSAS CITY BOARD OF TRADE,12/8/2009,001612,135613,29917,77112,32738,0,1480,26408,8804,10474,11366,7264,5869,118252,111003,17361,24610,-47195,-10385,-78690,46.10936242,32738,33518,9802,96.71108113,17604,37797,-380,47.10689682,-892,3504,-17008,78.56864275,520.5,1257.25,442.25,9.601226994
WHEAT - KANSAS CITY BOARD OF TRADE,12/1/2009,001612,134230,28476,78222,32832,0,1200,26569,7683,10504,12309,7176,5847,117737,110632,16493,23598,-49746,-10385,-78690,42.37464314,32832,33518,9802,97.10743802,18886,37797,-380,50.46493962,-1805,3504,-17008,74.1175897,556.75,1257.25,442.25,14.04907975
WHEAT - KANSAS CITY BOARD OF TRADE,11/24/2009,001612,133440,29662,76310,31659,0,1755,24794,8072,10214,12147,6673,5807,116038,108831,17402,24609,-46648,-10385,-78690,46.91018227,31659,33518,9802,92.16141002,16722,37797,-380,44.79660529,-1933,3504,-17008,73.49356474,529.5,1257.25,442.25,10.70552147
WHEAT - KANSAS CITY BOARD OF TRADE,11/17/2009,001612,138266,28394,74980,31934,266,1993,26270,9406,10749,11961,7068,5794,117095,110256,21171,28010,-46586,-10385,-78690,47.00095161,31668,33518,9802,92.19935908,16864,37797,-380,45.16855698,-1212,3504,-17008,77.00858034,574,1257.25,442.25,16.16564417
WHEAT - KANSAS CITY BOARD OF TRADE,11/9/2009,001612,133683,29407,69335,31012,315,1078,25100,15121,10484,12193,5901,6234,115508,108468,18175,25215,-39928,-10385,-78690,56.74840788,30697,33518,9802,88.10507674,9979,37797,-380,27.13413836,-1709,3504,-17008,74.58560842,521.75,1257.25,442.25,9.754601227
WHEAT - KANSAS CITY BOARD OF TRADE,11/3/2009,001612,129986,29195,68226,30269,274,1249,24131,14387,10695,12405,5766,4607,112551,105204,17435,24782,-39031,-10385,-78690,58.06163531,29995,33518,9802,85.14504976,9744,37797,-380,26.51858449,-1710,3504,-17008,74.58073323,520,1257.25,442.25,9.539877301
WHEAT - KANSAS CITY BOARD OF TRADE,10/27/2009,001612,126295,29254,69332,26967,224,1198,25267,12381,9472,12823,5336,3563,108544,101506,17751,24789,-40078,-10385,-78690,56.52880463,26743,33518,9802,71.43278799,12886,37797,-380,34.74867067,-3351,3504,-17008,66.58053822,510.5,1257.25,442.25,8.374233129
WHEAT - KANSAS CITY BOARD OF TRADE,10/20/2009,001612,124893,28089,65190,25749,259,1089,25576,15837,9038,13382,3863,4454,107377,99730,17516,25163,-37101,-10385,-78690,60.88719713,25490,33518,9802,66.14943498,9739,37797,-380,26.5054876,-4344,3504,-17008,61.73946958,525.75,1257.25,442.25,10.24539877
WHEAT - KANSAS CITY BOARD OF TRADE,10/13/2009,001612,126385,29245,62896,24296,353,1218,26335,20169,8831,13528,3491,4311,107764,101269,18621,25116,-33651,-10385,-78690,65.93807188,23943,33518,9802,59.62641255,6166,37797,-380,17.14644943,-4697,3504,-17008,60.01852574,525,1257.25,442.25,10.15337423
WHEAT - KANSAS CITY BOARD OF TRADE,10/6/2009,001612,122556,28705,59071,23237,367,1377,25849,24039,8400,13464,1922,3969,105001,99145,17555,23411,-30366,-10385,-78690,70.74738306,22870,33518,9802,55.10204082,1810,37797,-380,5.73643817,-5064,3504,-17008,58.22932917,475.5,1257.25,442.25,4.079754601
WHEAT - KANSAS CITY BOARD OF TRADE,9/29/2009,001612,122640,30856,58420,23671,361,1353,23179,23559,8110,13217,2134,4909,105295,98846,17345,23794,-27564,-10385,-78690,74.84957177,23310,33518,9802,56.95732839,-380,37797,-380,0,-5107,3504,-17008,58.01969579,468.5,1257.25,442.25,3.220858896
WHEAT - KANSAS CITY BOARD OF TRADE,9/22/2009,001612,116229,25759,55373,22352,360,1568,22780,22471,8114,13997,1586,4679,99249,94151,16980,22078,-29614,-10385,-78690,71.84832736,21992,33518,9802,51.3998988,309,37797,309,0,-5883,3504,-17008,54.23654446,468.25,1257.25,442.25,3.190184049
WHEAT - KANSAS CITY BOARD OF TRADE,9/15/2009,001612,111683,25444,53749,21617,361,1140,22665,21135,7975,13156,776,3904,95901,89040,15782,22643,-28305,-10385,-78690,73.76473172,21256,33518,9802,48.29650869,1530,37797,1530,0,-5181,3504,-17008,57.65893136,482.25,1257.25,442.25,4.90797546
WHEAT - KANSAS CITY BOARD OF TRADE,9/8/2009,001612,102301,23460,50359,20750,254,846,21806,17785,7706,11233,1081,2924,88725,80955,13576,21346,-26899,-10385,-78690,75.82314618,20496,33518,9802,45.09192107,4021,37797,1958,5.756299004,-3527,4148,-17008,63.72187559,465,1257.25,442.25,2.791411043
WHEAT - KANSAS CITY BOARD OF TRADE,9/1/2009,001612,99440,22889,49736,20706,247,670,21404,16549,6919,10853,1078,2493,85934,77692,13506,21748,-26847,-10385,-78690,75.89927531,20459,33518,9802,44.93590825,4855,37797,1958,8.083372862,-3934,4148,-17008,61.79807147,494.25,1257.25,442.25,6.380368098
WHEAT - KANSAS CITY BOARD OF TRADE,8/25/2009,001612,104861,24851,54138,20624,243,834,21617,16913,7380,11506,597,2367,89179,82472,15682,22389,-29287,-10385,-78690,72.32706244,20381,33518,9802,44.60701636,4704,37797,1958,7.662044142,-4126,4148,-17008,60.89052751,504.75,1257.25,442.25,7.668711656
WHEAT - KANSAS CITY BOARD OF TRADE,8/18/2009,001612,102530,24211,52960,19252,229,884,20958,14785,6781,9849,300,3967,85902,79906,16628,22624,-28749,-10385,-78690,73.1147061,19023,33518,9802,38.88092427,6173,37797,1958,11.76093083,-3068,4148,-17008,65.89147287,498.5,1257.25,442.25,6.901840491
WHEAT - KANSAS CITY BOARD OF TRADE,8/11/2009,001612,99429,22213,49084,18378,244,1051,19594,12866,6528,9491,231,3511,80766,73515,18663,25914,-26871,-10385,-78690,75.86413879,18134,33518,9802,35.13240007,6728,37797,1958,13.30952315,-2963,4148,-17008,66.38778597,517,1257.25,442.25,9.171779141
WHEAT - KANSAS CITY BOARD OF TRADE,8/4/2009,001612,100281,21802,52256,16661,211,1416,21298,10600,7435,10371,414,4010,82993,76342,17288,23939,-30454,-10385,-78690,70.61854915,16450,33518,9802,28.03170855,10698,37797,1958,24.38684115,-2936,4148,-17008,66.51540934,573,1257.25,442.25,16.04294479
WHEAT - KANSAS CITY BOARD OF TRADE,7/28/2009,001612,97960,22459,47650,16139,322,1900,19629,11623,7893,9573,479,4324,81917,74191,16043,23769,-25191,-10385,-79101,78.4533442,15817,33518,9802,25.36262439,8006,37797,1958,16.87547086,-1680,4148,-17008,72.45225941,550,1257.25,442.25,13.2208589
WHEAT - KANSAS CITY BOARD OF TRADE,7/21/2009,001612,95771,21727,46136,15318,362,1669,19301,11366,9167,8604,291,4236,80022,73227,15749,22544,-24409,-10385,-80738,80.0662374,14956,33518,9802,21.73216394,7935,37797,1958,16.67736265,563,4148,-17720,83.60618255,565.75,1257.25,442.25,15.15337423
WHEAT - KANSAS CITY BOARD OF TRADE,7/14/2009,001612,95578,24251,45201,14918,261,1665,18805,10761,9880,7411,1198,4149,81079,73115,14499,22463,-20950,-10385,-83048,85.46027552,14657,33518,9802,20.47141171,8044,37797,1958,16.9815006,2469,4148,-20281,93.12702116,550.5,1257.25,442.25,13.28220859
WHEAT - KANSAS CITY BOARD OF TRADE,7/7/2009,001612,88721,23370,44204,13941,248,1243,18762,7942,8677,5173,271,3487,74653,66072,14068,22649,-20834,-10385,-92110,87.21443867,13693,33518,9802,16.4066453,10820,45296,1958,20.44856708,3504,4148,-20281,97.36378894,535.25,1257.25,442.25,11.41104294
WHEAT - KANSAS CITY BOARD OF TRADE,6/30/2009,001612,86996,20875,42305,14078,235,903,18224,8831,8607,6150,693,3066,71903,64640,15093,22356,-21430,-10385,-92110,86.48516366,13843,33518,9802,17.0391297,9393,45296,1958,17.15584476,2457,4148,-20281,93.07789922,569.75,1257.25,442.25,15.64417178
WHEAT - KANSAS CITY BOARD OF TRADE,6/23/2009,001612,91426,22239,46702,13230,42,2413,18150,6271,8332,6906,2220,2639,73909,68619,17517,22807,-24463,-10385,-92110,82.77393698,13188,33518,9802,14.27728116,11879,45296,1958,22.89215008,1426,4148,-20281,88.85750542,604,1257.25,442.25,19.84662577
WHEAT - KANSAS CITY BOARD OF TRADE,6/16/2009,001612,98271,24623,51046,12432,167,2976,19659,5239,8134,6584,2147,4836,79244,74545,19027,23726,-26423,-10385,-92110,80.37565005,12265,33518,9802,10.38539383,14420,45296,1958,28.75536481,1550,4148,-20281,89.36509886,623,1257.25,442.25,22.17791411
WHEAT - KANSAS CITY BOARD OF TRADE,6/9/2009,001612,96659,20976,51114,12088,217,2600,21734,3309,6778,5866,3633,3929,73971,71580,22688,25079,-30138,-10385,-92110,75.82991741,11871,33518,9802,8.72406814,18425,45296,1958,37.99667728,912,4148,-20281,86.75344877,665.5,1257.25,442.25,27.39263804
WHEAT - KANSAS CITY BOARD OF TRADE,6/2/2009,001612,87022,18061,49099,12215,61,1516,23340,3370,3233,6420,4081,3392,68177,64752,18845,22270,-31038,0,0,0,12154,0,0,0,19970,0,0,0,-3187,0,0,0,719,0,0,0
WHEAT - KANSAS CITY BOARD OF TRADE,5/26/2009,001612,79895,14650,45278,13587,0,690,19539,3898,2945,7159,1467,3478,62048,57756,17847,22139,-30628,0,0,0,13587,0,0,0,15641,0,0,0,-4214,0,0,0,662.25,0,0,0
WHEAT - KANSAS CITY BOARD OF TRADE,5/19/2009,001612,76598,14586,43374,13157,0,781,18474,3260,2519,7014,1548,3311,59842,54793,16756,21805,-28788,0,0,0,13157,0,0,0,15214,0,0,0,-4495,0,0,0,642.75,0,0,0
WHEAT - KANSAS CITY BOARD OF TRADE,5/12/2009,001612,77488,14218,42138,12765,0,812,16999,3949,3747,7519,1083,3431,59491,55160,17997,22328,-27920,0,0,0,12765,0,0,0,13050,0,0,0,-3772,0,0,0,634,0,0,0
WHEAT - KANSAS CITY BOARD OF TRADE,5/5/2009,001612,75335,14406,35700,12057,0,806,17117,7798,3652,6850,999,3975,58863,52930,16472,22405,-21294,0,0,0,12057,0,0,0,9319,0,0,0,-3198,0,0,0,592.75,0,0,0
WHEAT - KANSAS CITY BOARD OF TRADE,4/28/2009,001612,77499,18100,34981,12337,72,846,17066,10546,3270,6395,1245,3854,61868,54814,15631,22685,-16881,0,0,0,12265,0,0,0,6520,0,0,0,-3125,0,0,0,565,0,0,0
WHEAT - KANSAS CITY BOARD OF TRADE,4/21/2009,001612,80820,19434,36359,12174,353,1775,16449,10445,3827,7283,1701,3412,64354,57872,16466,22948,-16925,0,0,0,11821,0,0,0,6004,0,0,0,-3456,0,0,0,563.25,0,0,0
WHEAT - KANSAS CITY BOARD OF TRADE,4/14/2009,001612,81691,19448,40716,12225,173,1758,17079,8004,3905,6754,1072,3733,64902,59361,16789,22330,-21268,0,0,0,12052,0,0,0,9075,0,0,0,-2849,0,0,0,564.5,0,0,0
WHEAT - KANSAS CITY BOARD OF TRADE,4/7/2009,001612,80418,18285,41333,12643,173,1231,17821,7113,2994,6090,1203,3715,62779,57762,17639,22656,-23048,0,0,0,12470,0,0,0,10708,0,0,0,-3096,0,0,0,590,0,0,0
WHEAT - KANSAS CITY BOARD OF TRADE,3/31/2009,001612,83519,19725,38292,12752,174,718,18995,11649,4468,6183,2128,4331,67172,61760,16347,21759,-18567,0,0,0,12578,0,0,0,7346,0,0,0,-1715,0,0,0,573.25,0,0,0
WHEAT - KANSAS CITY BOARD OF TRADE,3/24/2009,001612,80905,17742,39969,13420,162,677,19718,8674,3844,6799,2766,4183,66383,60275,14522,20630,-22227,0,0,0,13258,0,0,0,11044,0,0,0,-2955,0,0,0,588,0,0,0
WHEAT - KANSAS CITY BOARD OF TRADE,3/17/2009,001612,79201,17161,36705,13132,163,800,18123,9816,3331,6915,2655,3975,63437,57445,15764,21756,-19544,0,0,0,12969,0,0,0,8307,0,0,0,-3584,0,0,0,605.25,0,0,0
WHEAT - KANSAS CITY BOARD OF TRADE,3/10/2009,001612,76335,17405,32915,13505,61,835,15311,12065,3042,7056,2487,4066,61220,55471,15115,20864,-15510,0,0,0,13444,0,0,0,3246,0,0,0,-4014,0,0,0,580.25,0,0,0
WHEAT - KANSAS CITY BOARD OF TRADE,3/3/2009,001612,77606,19860,32669,12884,527,1680,14748,12746,2880,6841,2320,3821,62714,56643,14892,20963,-12809,0,0,0,12357,0,0,0,2002,0,0,0,-3961,0,0,0,538.75,0,0,0
WHEAT - KANSAS CITY BOARD OF TRADE,2/24/2009,001612,79029,19668,34520,13255,958,1845,14595,12091,3244,7164,1799,3559,63330,58016,15699,21013,-14852,0,0,0,12297,0,0,0,2504,0,0,0,-3920,0,0,0,553.25,0,0,0
WHEAT - KANSAS CITY BOARD OF TRADE,2/17/2009,001612,83239,21680,35989,13200,998,1832,16853,12459,4627,6154,2152,4093,68439,62150,14800,21089,-14309,0,0,0,12202,0,0,0,4394,0,0,0,-1527,0,0,0,550.75,0,0,0
WHEAT - KANSAS CITY BOARD OF TRADE,2/10/2009,001612,81745,18252,37472,12829,543,2016,17765,9801,4163,5958,1592,3590,64573,59177,17172,22568,-19220,0,0,0,12286,0,0,0,7964,0,0,0,-1795,0,0,0,589,0,0,0
WHEAT - KANSAS CITY BOARD OF TRADE,2/3/2009,001612,78111,18082,37898,12403,77,2012,16825,8304,3908,5422,1550,3421,62073,57170,16038,20941,-19816,0,0,0,12326,0,0,0,8521,0,0,0,-1514,0,0,0,581,0,0,0
WHEAT - KANSAS CITY BOARD OF TRADE,1/27/2009,001612,79084,18181,39134,13412,127,1590,16386,7892,4086,5718,991,3342,62715,57162,16369,21922,-20953,0,0,0,13285,0,0,0,8494,0,0,0,-1632,0,0,0,615,0,0,0
WHEAT - KANSAS CITY BOARD OF TRADE,1/20/2009,001612,80015,20456,39719,13106,101,1582,15164,7766,5807,5298,1240,2646,64059,58861,15956,21154,-19263,0,0,0,13005,0,0,0,7398,0,0,0,509,0,0,0,579.75,0,0,0
WHEAT - KANSAS CITY BOARD OF TRADE,1/13/2009,001612,80730,19731,41461,12987,101,2107,15756,6646,5543,5532,1429,2136,63792,59423,16938,21307,-21730,0,0,0,12886,0,0,0,9110,0,0,0,11,0,0,0,597,0,0,0
WHEAT - KANSAS CITY BOARD OF TRADE,1/6/2009,001612,84127,21107,44264,15111,1305,1561,16295,6899,6336,5773,1071,1977,68160,63413,15967,20714,-23157,0,0,0,13806,0,0,0,9396,0,0,0,563,0,0,0,670,0,0,0
WHEAT - KANSAS CITY BOARD OF TRADE,12/30/2008,001612,82853,22468,42584,14262,2429,1570,15844,7406,6235,5323,652,1979,67681,62855,15172,19998,-20116,0,0,0,11833,0,0,0,8438,0,0,0,912,0,0,0,621.75,0,0,0
WHEAT - KANSAS CITY BOARD OF TRADE,12/22/2008,001612,82506,24071,41288,13757,1941,1969,14408,8226,6201,5108,623,1915,67429,62163,15077,20343,-17217,0,0,0,11816,0,0,0,6182,0,0,0,1093,0,0,0,589.25,0,0,0
WHEAT - KANSAS CITY BOARD OF TRADE,12/16/2008,001612,80720,24522,40304,13283,1914,1583,14363,8635,5997,5219,613,1496,66463,60542,14257,20178,-15782,0,0,0,11369,0,0,0,5728,0,0,0,778,0,0,0,565,0,0,0
WHEAT - KANSAS CITY BOARD OF TRADE,12/9/2008,001612,77752,23813,37321,13066,1892,1240,12935,8444,6110,5135,801,1580,63879,57388,13873,20364,-13508,0,0,0,11174,0,0,0,4491,0,0,0,975,0,0,0,500,0,0,0
WHEAT - KANSAS CITY BOARD OF TRADE,12/2/2008,001612,78001,23401,37430,12880,1528,1349,13669,9406,5956,5245,896,1771,64271,58336,13730,19665,-14029,0,0,0,11352,0,0,0,4263,0,0,0,711,0,0,0,537.5,0,0,0
WHEAT - KANSAS CITY BOARD OF TRADE,11/25/2008,001612,79802,24574,38265,12544,1639,1316,13649,9704,5945,5007,298,1924,64959,59091,14843,20711,-13691,0,0,0,10905,0,0,0,3945,0,0,0,938,0,0,0,562.25,0,0,0
WHEAT - KANSAS CITY BOARD OF TRADE,11/18/2008,001612,91565,27279,41795,12163,1613,1544,14019,9159,6553,5879,622,1577,69014,62863,22551,28702,-14516,0,0,0,10550,0,0,0,4860,0,0,0,674,0,0,0,561,0,0,0
WHEAT - KANSAS CITY BOARD OF TRADE,11/11/2008,001612,93164,28143,41127,11637,1571,1230,14464,9503,8061,6786,1669,1517,71838,64678,21326,28486,-12984,0,0,0,10066,0,0,0,4961,0,0,0,1275,0,0,0,571,0,0,0
WHEAT - KANSAS CITY BOARD OF TRADE,11/4/2008,001612,88840,29140,41573,11747,1475,1229,13700,9932,8329,6984,1149,1645,72774,65332,16066,23508,-12433,0,0,0,10272,0,0,0,3768,0,0,0,1345,0,0,0,609,0,0,0
WHEAT - KANSAS CITY BOARD OF TRADE,10/28/2008,001612,89271,30106,41294,11428,1626,1114,14018,10571,8631,6733,1333,1456,73486,66025,15785,23246,-11188,0,0,0,9802,0,0,0,3447,0,0,0,1898,0,0,0,553.25,0,0,0
WHEAT - KANSAS CITY BOARD OF TRADE,10/21/2008,001612,88815,30449,41155,12151,1677,1112,12626,10668,8521,7019,1243,1420,73298,65796,15517,23019,-10706,0,0,0,10474,0,0,0,1958,0,0,0,1502,0,0,0,582,0,0,0
WHEAT - KANSAS CITY BOARD OF TRADE,10/14/2008,001612,89517,30061,40446,12811,897,1112,12029,10019,8823,7384,1453,1377,73597,64127,15920,25390,-10385,0,0,0,11914,0,0,0,2010,0,0,0,1439,0,0,0,613,0,0,0
WHEAT - KANSAS CITY BOARD OF TRADE,10/7/2008,001612,89776,28250,41195,12345,769,1734,13373,10267,8814,7754,1078,1286,73556,65143,16220,24633,-12945,0,0,0,11576,0,0,0,3106,0,0,0,1060,0,0,0,634,0,0,0
WHEAT - KANSAS CITY BOARD OF TRADE,9/30/2008,001612,89221,26658,45172,15414,0,977,13038,10781,7740,8378,1013,1438,73643,67121,15578,22100,-18514,0,0,0,15414,0,0,0,2257,0,0,0,-638,0,0,0,712,0,0,0
WHEAT - KANSAS CITY BOARD OF TRADE,9/23/2008,001612,92404,24563,46882,16299,0,976,14217,9760,7465,8455,997,1222,73197,67302,19207,25102,-22319,0,0,0,16299,0,0,0,4457,0,0,0,-990,0,0,0,781.5,0,0,0
WHEAT - KANSAS CITY BOARD OF TRADE,9/16/2008,001612,93414,24269,47515,18593,0,976,14487,8603,7238,7629,937,1609,74801,66878,18613,26536,-23246,0,0,0,18593,0,0,0,5884,0,0,0,-391,0,0,0,734.5,0,0,0
WHEAT - KANSAS CITY BOARD OF TRADE,9/9/2008,001612,89909,24722,49512,16567,320,836,16804,6155,7009,5918,1215,1908,73764,66955,16145,22954,-24790,0,0,0,16247,0,0,0,10649,0,0,0,1091,0,0,0,754,0,0,0
WHEAT - KANSAS CITY BOARD OF TRADE,9/2/2008,001612,93034,23404,48994,17135,320,836,18265,5180,7303,6010,1530,1753,74706,65916,18328,27118,-25590,0,0,0,16815,0,0,0,13085,0,0,0,1293,0,0,0,792.75,0,0,0
WHEAT - KANSAS CITY BOARD OF TRADE,8/26/2008,001612,97654,25397,53873,15841,380,2678,21479,3988,7473,6115,1270,2436,81419,72098,16235,25556,-28476,0,0,0,15461,0,0,0,17491,0,0,0,1358,0,0,0,865.75,0,0,0
WHEAT - KANSAS CITY BOARD OF TRADE,8/19/2008,001612,100429,28208,53229,14425,320,1585,20974,4375,8694,6408,1938,1849,82143,71990,18286,28439,-25021,0,0,0,14105,0,0,0,16599,0,0,0,2286,0,0,0,880.5,0,0,0
WHEAT - KANSAS CITY BOARD OF TRADE,8/12/2008,001612,96705,25724,46396,15412,320,1336,19613,6850,8500,5914,2318,2060,78559,67780,18146,28925,-20672,0,0,0,15092,0,0,0,12763,0,0,0,2586,0,0,0,827,0,0,0
WHEAT - KANSAS CITY BOARD OF TRADE,8/5/2008,001612,98655,25285,44230,15675,320,1115,18462,7037,9776,7052,3626,2975,80340,69079,18315,29576,-18945,0,0,0,15355,0,0,0,11425,0,0,0,2724,0,0,0,806.5,0,0,0
WHEAT - KANSAS CITY BOARD OF TRADE,7/29/2008,001612,99334,28878,48868,17862,320,1230,17751,6940,8436,5987,4350,3131,83275,73275,16059,26059,-19990,0,0,0,17542,0,0,0,10811,0,0,0,2449,0,0,0,825,0,0,0
WHEAT - KANSAS CITY BOARD OF TRADE,7/22/2008,001612,100645,31430,50231,18372,320,1184,16760,6123,7670,6330,6214,2862,84608,74604,16037,26041,-18801,0,0,0,18052,0,0,0,10637,0,0,0,1340,0,0,0,824,0,0,0
WHEAT - KANSAS CITY BOARD OF TRADE,7/15/2008,001612,98789,29958,49786,18516,340,884,16215,5237,6770,5735,6287,3185,81263,72489,17526,26300,-19828,0,0,0,18176,0,0,0,10978,0,0,0,1035,0,0,0,844,0,0,0
WHEAT - KANSAS CITY BOARD OF TRADE,7/8/2008,001612,101263,27216,50024,18697,0,883,16983,5067,6960,6786,6316,3783,81308,73033,19955,28230,-22808,0,0,0,18697,0,0,0,11916,0,0,0,174,0,0,0,849,0,0,0
WHEAT - KANSAS CITY BOARD OF TRADE,7/1/2008,001612,99626,24746,50058,18363,0,906,18302,3440,6749,7192,6322,4119,80377,71594,19249,28032,-25312,0,0,0,18363,0,0,0,14862,0,0,0,-443,0,0,0,874,0,0,0
WHEAT - KANSAS CITY BOARD OF TRADE,6/24/2008,001612,105226,26513,53663,20138,0,1035,19053,2426,5747,6865,6548,5221,84572,74640,20654,30586,-27150,0,0,0,20138,0,0,0,16627,0,0,0,-1118,0,0,0,909.5,0,0,0
WHEAT - KANSAS CITY BOARD OF TRADE,6/17/2008,001612,114833,29017,58945,20059,0,1045,21323,2794,7013,9134,6843,6918,94509,83558,20324,31275,-29928,0,0,0,20059,0,0,0,18529,0,0,0,-2121,0,0,0,939,0,0,0
WHEAT - KANSAS CITY BOARD OF TRADE,6/10/2008,001612,117393,28892,58249,20192,0,1981,22469,3869,6842,10053,6670,6855,97284,84466,20109,32927,-29357,0,0,0,20192,0,0,0,18600,0,0,0,-3211,0,0,0,846.5,0,0,0
WHEAT - KANSAS CITY BOARD OF TRADE,6/3/2008,001612,110211,26488,54715,20776,0,1768,22969,4064,6000,9527,6863,6138,93666,79548,16545,30663,-28227,0,0,0,20776,0,0,0,18905,0,0,0,-3527,0,0,0,788,0,0,0
WHEAT - KANSAS CITY BOARD OF TRADE,5/27/2008,001612,106211,25964,55386,20363,0,1647,23456,3976,4356,9809,6198,5297,90892,76860,15319,29351,-29422,0,0,0,20363,0,0,0,19480,0,0,0,-5453,0,0,0,805,0,0,0
WHEAT - KANSAS CITY BOARD OF TRADE,5/20/2008,001612,103676,25737,54677,20809,0,1261,23507,3572,4197,9355,6290,4329,89195,74326,14481,29350,-28940,0,0,0,20809,0,0,0,19935,0,0,0,-5158,0,0,0,830.75,0,0,0
WHEAT - KANSAS CITY BOARD OF TRADE,5/13/2008,001612,99429,23369,54367,21085,0,1172,23377,3041,4161,9369,6172,3258,85791,72171,13638,27258,-30998,0,0,0,21085,0,0,0,20336,0,0,0,-5208,0,0,0,873,0,0,0
WHEAT - KANSAS CITY BOARD OF TRADE,5/6/2008,001612,100872,25411,57413,20940,0,1004,23481,2903,3899,9144,5610,3382,87261,74211,13611,26661,-32002,0,0,0,20940,0,0,0,20578,0,0,0,-5245,0,0,0,904,0,0,0
WHEAT - KANSAS CITY BOARD OF TRADE,4/29/2008,001612,101361,27778,59550,20264,0,621,22889,2705,3146,9485,5409,3165,87348,74596,14013,26765,-31772,0,0,0,20264,0,0,0,20184,0,0,0,-6339,0,0,0,848,0,0,0
WHEAT - KANSAS CITY BOARD OF TRADE,4/22/2008,001612,102993,27514,61837,20659,28,491,22263,1838,3873,9987,3886,4555,89342,76508,13651,26485,-34323,0,0,0,20631,0,0,0,20425,0,0,0,-6114,0,0,0,911,0,0,0
WHEAT - KANSAS CITY BOARD OF TRADE,4/15/2008,001612,105762,28322,63762,20263,24,600,23080,1845,4323,9651,3487,3090,89329,77131,16433,28631,-35440,0,0,0,20239,0,0,0,21235,0,0,0,-5328,0,0,0,950.25,0,0,0
WHEAT - KANSAS CITY BOARD OF TRADE,4/8/2008,001612,108559,27793,65535,20751,20,420,24364,1508,4119,9673,3452,3428,90548,78482,18011,30077,-37742,0,0,0,20731,0,0,0,22856,0,0,0,-5554,0,0,0,987,0,0,0
WHEAT - KANSAS CITY BOARD OF TRADE,4/1/2008,001612,110683,30368,68235,20725,104,481,25574,1848,3958,9103,2794,3022,93231,80442,17452,30241,-37867,0,0,0,20621,0,0,0,23726,0,0,0,-5145,0,0,0,950,0,0,0
WHEAT - KANSAS CITY BOARD OF TRADE,3/25/2008,001612,110129,27850,71149,20823,62,281,29465,1545,3408,9858,2922,2299,93984,81666,16145,28463,-43299,0,0,0,20761,0,0,0,27920,0,0,0,-6450,0,0,0,1119,0,0,0
WHEAT - KANSAS CITY BOARD OF TRADE,3/18/2008,001612,112312,28488,73635,21557,82,277,29852,1424,3728,11138,3608,1909,96949,84663,15363,27649,-45147,0,0,0,21475,0,0,0,28428,0,0,0,-7410,0,0,0,1213,0,0,0
WHEAT - KANSAS CITY BOARD OF TRADE,3/11/2008,001612,115577,28234,74865,21672,42,89,30259,1253,3931,11975,4048,1868,98028,86096,17549,29481,-46631,0,0,0,21630,0,0,0,29006,0,0,0,-8044,0,0,0,1250,0,0,0
WHEAT - KANSAS CITY BOARD OF TRADE,3/4/2008,001612,114323,26345,72895,21340,159,267,31542,1470,4375,11786,3551,1854,97509,84571,16814,29752,-46550,0,0,0,21181,0,0,0,30072,0,0,0,-7411,0,0,0,1153,0,0,0
WHEAT - KANSAS CITY BOARD OF TRADE,2/26/2008,001612,117769,27445,76116,20878,126,297,32108,1145,4192,11590,2836,1678,98188,86390,19581,31379,-48671,0,0,0,20752,0,0,0,30963,0,0,0,-7398,0,0,0,1257.25,0,0,0
WHEAT - KANSAS CITY BOARD OF TRADE,2/19/2008,001612,122792,29087,76748,21126,119,148,33757,1345,3954,10466,3783,2326,100864,88423,21928,34369,-47661,0,0,0,21007,0,0,0,32412,0,0,0,-6512,0,0,0,1084.5,0,0,0
WHEAT - KANSAS CITY BOARD OF TRADE,2/12/2008,001612,127912,29849,79956,20708,118,126,35870,1384,4806,10752,3785,3082,105193,93257,22719,34655,-50107,0,0,0,20590,0,0,0,34486,0,0,0,-5946,0,0,0,1045.5,0,0,0
WHEAT - KANSAS CITY BOARD OF TRADE,2/5/2008,001612,126525,30620,77547,21439,125,18,34074,817,5345,9392,4976,2863,103751,91691,22774,34834,-46927,0,0,0,21314,0,0,0,33257,0,0,0,-4047,0,0,0,1050.25,0,0,0
WHEAT - KANSAS CITY BOARD OF TRADE,1/29/2008,001612,125031,31158,77209,21531,258,130,32787,623,6285,9771,4905,3128,104790,92538,20241,32493,-46051,0,0,0,21273,0,0,0,32164,0,0,0,-3486,0,0,0,990.25,0,0,0
WHEAT - KANSAS CITY BOARD OF TRADE,1/22/2008,001612,125754,30692,78051,22204,215,18,33936,963,6482,10162,5070,2034,105528,92833,20226,32921,-47359,0,0,0,21989,0,0,0,32973,0,0,0,-3680,0,0,0,984.75,0,0,0
WHEAT - KANSAS CITY BOARD OF TRADE,1/15/2008,001612,121535,30216,75393,22361,201,18,30763,913,5504,10119,5167,1855,100836,89051,20699,32484,-45177,0,0,0,22160,0,0,0,29850,0,0,0,-4615,0,0,0,956,0,0,0
WHEAT - KANSAS CITY BOARD OF TRADE,1/8/2008,001612,122274,30489,79083,25729,206,18,31358,903,3889,9324,5583,1795,102602,91477,19672,30797,-48594,0,0,0,25523,0,0,0,30455,0,0,0,-5435,0,0,0,909.25,0,0,0
WHEAT - KANSAS CITY BOARD OF TRADE,12/31/2007,001612,122611,29342,79125,27549,206,18,31444,957,3395,9322,5882,927,101997,90510,20614,32101,-49783,0,0,0,27343,0,0,0,30487,0,0,0,-5927,0,0,0,913.5,0,0,0
WHEAT - KANSAS CITY BOARD OF TRADE,12/24/2007,001612,119502,27416,78400,28150,236,18,32497,880,3036,9868,6059,841,101826,89470,17676,30032,-50984,0,0,0,27914,0,0,0,31617,0,0,0,-6832,0,0,0,964,0,0,0
WHEAT - KANSAS CITY BOARD OF TRADE,12/18/2007,001612,120506,26703,80675,28406,244,18,32894,768,2894,10677,6144,823,102415,91566,18091,28940,-53972,0,0,0,28162,0,0,0,32126,0,0,0,-7783,0,0,0,971.5,0,0,0
WHEAT - KANSAS CITY BOARD OF TRADE,12/11/2007,001612,123220,25810,83657,28698,467,38,34446,775,2792,12269,6276,821,104874,94826,18346,28394,-57847,0,0,0,28231,0,0,0,33671,0,0,0,-9477,0,0,0,949,0,0,0
WHEAT - KANSAS CITY BOARD OF TRADE,12/4/2007,001612,120902,26857,80834,28599,622,98,31852,639,3156,11916,6656,919,103397,92924,17505,27978,-53977,0,0,0,27977,0,0,0,31213,0,0,0,-8760,0,0,0,913,0,0,0
WHEAT - KANSAS CITY BOARD OF TRADE,11/27/2007,001612,122778,29561,80333,28793,349,146,29309,1531,3209,11316,5714,1466,103800,92748,18978,30030,-50772,0,0,0,28444,0,0,0,27778,0,0,0,-8107,0,0,0,852.25,0,0,0
WHEAT - KANSAS CITY BOARD OF TRADE,11/20/2007,001612,128914,31998,82691,28828,303,79,30987,1576,3537,12284,6107,1204,108917,95497,19997,33417,-50693,0,0,0,28525,0,0,0,29411,0,0,0,-8747,0,0,0,800.25,0,0,0
WHEAT - KANSAS CITY BOARD OF TRADE,11/13/2007,001612,129101,31942,82414,28702,152,250,29371,732,3564,12088,5422,1887,107804,94421,21297,34680,-50472,0,0,0,28550,0,0,0,28639,0,0,0,-8524,0,0,0,762,0,0,0
WHEAT - KANSAS CITY BOARD OF TRADE,11/6/2007,001612,140789,30581,85443,29887,140,80,32534,635,2877,12397,6020,6166,114522,101361,26267,39428,-54862,0,0,0,29747,0,0,0,31899,0,0,0,-9520,0,0,0,822.25,0,0,0
WHEAT - KANSAS CITY BOARD OF TRADE,10/30/2007,001612,138602,31611,87482,30814,166,54,33057,783,4370,11834,6665,7382,119122,106902,19480,31700,-55871,0,0,0,30648,0,0,0,32274,0,0,0,-7464,0,0,0,837,0,0,0
WHEAT - KANSAS CITY BOARD OF TRADE,10/23/2007,001612,137481,29702,86231,30868,194,65,33651,479,3581,11735,7627,7889,117491,106066,19990,31415,-56529,0,0,0,30674,0,0,0,33172,0,0,0,-8154,0,0,0,859.75,0,0,0
WHEAT - KANSAS CITY BOARD OF TRADE,10/16/2007,001612,132896,27446,83962,29483,220,0,33661,425,2918,12259,7933,5131,110898,100589,21998,32307,-56516,0,0,0,29263,0,0,0,33236,0,0,0,-9341,0,0,0,838,0,0,0
WHEAT - KANSAS CITY BOARD OF TRADE,10/9/2007,001612,134740,27326,86164,31180,220,0,33653,855,2671,12533,10147,3595,110958,103652,23782,31088,-58838,0,0,0,30960,0,0,0,32798,0,0,0,-9862,0,0,0,844.25,0,0,0
WHEAT - KANSAS CITY BOARD OF TRADE,10/2/2007,001612,142837,31951,95733,31723,220,0,37216,1135,2608,12741,10110,1914,118153,111720,24684,31117,-63782,0,0,0,31503,0,0,0,36081,0,0,0,-10133,0,0,0,919.25,0,0,0
WHEAT - KANSAS CITY BOARD OF TRADE,9/25/2007,001612,143598,32273,99318,32963,216,4,38451,3196,2553,13787,10240,1344,121375,116871,22223,26727,-67045,0,0,0,32747,0,0,0,35255,0,0,0,-11234,0,0,0,873.25,0,0,0
WHEAT - KANSAS CITY BOARD OF TRADE,9/18/2007,001612,145340,31151,102016,33227,100,100,38705,3176,2560,15919,9966,1177,122839,119095,22501,26245,-70865,0,0,0,33127,0,0,0,35529,0,0,0,-13359,0,0,0,848.75,0,0,0
WHEAT - KANSAS CITY BOARD OF TRADE,9/11/2007,001612,155402,34774,109567,33404,147,138,38453,2937,3002,16949,9363,1204,127924,126358,27478,29044,-74793,0,0,0,33257,0,0,0,35516,0,0,0,-13947,0,0,0,860,0,0,0
WHEAT - KANSAS CITY BOARD OF TRADE,9/4/2007,001612,150817,33783,111061,33698,180,175,38581,2917,3492,17778,8804,871,128378,127500,22439,23317,-77278,0,0,0,33518,0,0,0,35664,0,0,0,-14286,0,0,0,751,0,0,0
WHEAT - KANSAS CITY BOARD OF TRADE,8/28/2007,001612,155159,35276,113966,33196,220,178,39830,2741,3303,18057,8677,1203,131043,130288,24116,24871,-78690,0,0,0,32976,0,0,0,37089,0,0,0,-14754,0,0,0,680.5,0,0,0
WHEAT - KANSAS CITY BOARD OF TRADE,8/21/2007,001612,156078,34641,111120,30922,220,413,39481,3060,2691,19699,8980,1288,129135,127772,26943,28306,-76479,0,0,0,30702,0,0,0,36421,0,0,0,-17008,0,0,0,655,0,0,0
WHEAT - KANSAS CITY BOARD OF TRADE,8/14/2007,001612,158267,32831,110943,31640,220,496,41336,3539,3354,18703,8853,1400,129760,128805,28507,29462,-78112,0,0,0,31420,0,0,0,37797,0,0,0,-15349,0,0,0,672.25,0,0,0
WHEAT - KANSAS CITY BOARD OF TRADE,8/7/2007,001612,154503,30204,107575,32628,220,869,42254,4537,4268,17578,7964,1409,129210,126842,25293,27661,-77371,0,0,0,32408,0,0,0,37717,0,0,0,-13310,0,0,0,648,0,0,0
WHEAT - KANSAS CITY BOARD OF TRADE,7/31/2007,001612,151080,30036,107592,32981,220,970,41295,6393,4525,16464,4562,786,127057,125048,24023,26032,-77556,0,0,0,32761,0,0,0,34902,0,0,0,-11939,0,0,0,629,0,0,0
WHEAT - KANSAS CITY BOARD OF TRADE,7/24/2007,001612,148686,28150,105006,32353,220,696,38487,6641,4036,17393,4163,2258,123373,123020,25313,25666,-76856,0,0,0,32133,0,0,0,31846,0,0,0,-13357,0,0,0,630,0,0,0
WHEAT - KANSAS CITY BOARD OF TRADE,7/17/2007,001612,140993,24243,98250,32635,220,203,36533,6831,3839,15901,3435,2272,115626,115050,25367,25943,-74007,0,0,0,32415,0,0,0,29702,0,0,0,-12062,0,0,0,586,0,0,0
WHEAT - KANSAS CITY BOARD OF TRADE,7/10/2007,001612,134518,19660,92363,31104,0,88,38739,4720,3290,13781,2675,3352,110014,106488,24504,28030,-72703,0,0,0,31104,0,0,0,34019,0,0,0,-10491,0,0,0,600,0,0,0
WHEAT - KANSAS CITY BOARD OF TRADE,7/3/2007,001612,128855,18687,87952,31074,0,0,36776,4650,3475,13189,2311,3359,106560,101747,22295,27108,-69265,0,0,0,31074,0,0,0,32126,0,0,0,-9714,0,0,0,585,0,0,0
WHEAT - KANSAS CITY BOARD OF TRADE,6/26/2007,001612,124936,20297,84988,29539,0,17,32498,1964,3348,11748,2238,3513,100960,96068,23976,28868,-64691,0,0,0,29539,0,0,0,30534,0,0,0,-8400,0,0,0,588.5,0,0,0
WHEAT - KANSAS CITY BOARD OF TRADE,6/19/2007,001612,125846,21550,79193,28097,0,8,28930,3084,3640,12384,3360,3672,98281,92957,27565,32889,-57643,0,0,0,28097,0,0,0,25846,0,0,0,-8744,0,0,0,569.25,0,0,0
WHEAT - KANSAS CITY BOARD OF TRADE,6/12/2007,001612,129190,25734,72025,28887,0,102,26013,9331,4082,11785,2796,3989,100592,92325,28598,36865,-46291,0,0,0,28887,0,0,0,16682,0,0,0,-7703,0,0,0,559,0,0,0
WHEAT - KANSAS CITY BOARD OF TRADE,6/5/2007,001612,124454,29573,64263,29994,301,242,20234,14469,4266,11957,2670,4675,100941,90886,23513,33568,-34690,0,0,0,29693,0,0,0,5765,0,0,0,-7691,0,0,0,510.5,0,0,0
WHEAT - KANSAS CITY BOARD OF TRADE,5/29/2007,001612,118729,28493,60048,29785,940,712,20247,17403,3338,11099,2207,4856,98530,89504,20199,29225,-31555,0,0,0,28845,0,0,0,2844,0,0,0,-7761,0,0,0,481,0,0,0
WHEAT - KANSAS CITY BOARD OF TRADE,5/22/2007,001612,120546,26799,59425,29192,940,712,21638,17776,3217,11295,2231,4736,97589,89037,22957,31509,-32626,0,0,0,28252,0,0,0,3862,0,0,0,-8078,0,0,0,464.75,0,0,0
WHEAT - KANSAS CITY BOARD OF TRADE,5/15/2007,001612,119872,27220,59998,28476,941,712,25314,20073,3217,10421,3218,4432,99792,92591,20080,27281,-32778,0,0,0,27535,0,0,0,5241,0,0,0,-7204,0,0,0,489.5,0,0,0
WHEAT - KANSAS CITY BOARD OF TRADE,5/8/2007,001612,120606,27167,63310,28508,942,645,24557,18763,3614,9823,2114,3814,98128,93202,22478,27404,-36143,0,0,0,27566,0,0,0,5794,0,0,0,-6209,0,0,0,471,0,0,0
WHEAT - KANSAS CITY BOARD OF TRADE,5/1/2007,001612,123720,29265,66096,28521,940,659,24212,18557,3639,10475,2485,4806,101577,97182,22143,26538,-36831,0,0,0,27581,0,0,0,5655,0,0,0,-6836,0,0,0,485,0,0,0
WHEAT - KANSAS CITY BOARD OF TRADE,4/24/2007,001612,129402,27150,67469,28117,930,656,25078,15486,3853,10906,1938,3929,99689,94261,29713,35141,-40319,0,0,0,27187,0,0,0,9592,0,0,0,-7053,0,0,0,493.75,0,0,0
WHEAT - KANSAS CITY BOARD OF TRADE,4/17/2007,001612,131835,29124,68006,22684,930,636,25640,15906,4687,10770,3118,4262,97803,97545,34032,34290,-38882,0,0,0,21754,0,0,0,9734,0,0,0,-6083,0,0,0,492,0,0,0
WHEAT - KANSAS CITY BOARD OF TRADE,4/10/2007,001612,133608,28902,69266,22394,310,566,26382,14125,7828,16098,3555,4204,106374,99854,27234,33754,-40364,0,0,0,22084,0,0,0,12257,0,0,0,-8270,0,0,0,477.5,0,0,0
WHEAT - KANSAS CITY BOARD OF TRADE,4/3/2007,001612,132977,31104,69633,22737,310,587,28338,14258,7611,14872,3530,5161,110410,101090,22567,31887,-38529,0,0,0,22427,0,0,0,14080,0,0,0,-7261,0,0,0,442.25,0,0,0
WHEAT - KANSAS CITY BOARD OF TRADE,3/27/2007,001612,126055,23699,69026,24103,161,220,30860,10228,7916,15429,4068,3748,105975,95367,20080,30688,-45327,0,0,0,23942,0,0,0,20632,0,0,0,-7513,0,0,0,470.25,0,0,0
WHEAT - KANSAS CITY BOARD OF TRADE,3/20/2007,001612,117571,20167,66596,23937,0,148,31309,7886,7938,14803,4343,2813,101115,89724,16456,27847,-46429,0,0,0,23937,0,0,0,23423,0,0,0,-6865,0,0,0,483.5,0,0,0
WHEAT - KANSAS CITY BOARD OF TRADE,3/13/2007,001612,113763,16877,65183,25552,0,147,30931,5634,7191,13894,4370,2646,97238,85171,16525,28592,-48306,0,0,0,25552,0,0,0,25297,0,0,0,-6703,0,0,0,500,0,0,0
WHEAT - KANSAS CITY BOARD OF TRADE,3/6/2007,001612,113339,16540,67086,25629,0,147,31291,5467,7350,14297,4198,2367,97621,86615,15718,26724,-50546,0,0,0,25629,0,0,0,25824,0,0,0,-6947,0,0,0,501,0,0,0
WHEAT - KANSAS CITY BOARD OF TRADE,2/27/2007,001612,118644,18723,67846,25707,0,147,30412,6108,7040,14076,4295,2554,98659,87990,19985,30654,-49123,0,0,0,25707,0,0,0,24304,0,0,0,-7036,0,0,0,497.5,0,0,0
WHEAT - KANSAS CITY BOARD OF TRADE,2/20/2007,001612,115434,18190,64130,26231,0,147,29441,7101,8633,11819,4382,2832,97293,87225,18141,28209,-45940,0,0,0,26231,0,0,0,22340,0,0,0,-3186,0,0,0,493,0,0,0
WHEAT - KANSAS CITY BOARD OF TRADE,2/13/2007,001612,118191,20672,63213,26232,1392,147,27183,7087,8380,11546,4468,2053,96213,86740,21978,31451,-42541,0,0,0,24840,0,0,0,20096,0,0,0,-3166,0,0,0,487.5,0,0,0
WHEAT - KANSAS CITY BOARD OF TRADE,2/6/2007,001612,119167,19511,62397,26372,1439,217,27474,6944,8515,12313,4481,3193,97595,87186,21572,31981,-42886,0,0,0,24933,0,0,0,20530,0,0,0,-3798,0,0,0,476.5,0,0,0
WHEAT - KANSAS CITY BOARD OF TRADE,1/30/2007,001612,117064,18323,59737,25436,1839,147,27066,6864,8867,12485,4236,3124,95448,84814,21616,32250,-41414,0,0,0,23597,0,0,0,20202,0,0,0,-3618,0,0,0,481.75,0,0,0
WHEAT - KANSAS CITY BOARD OF TRADE,1/23/2007,001612,116457,19069,60609,25421,1989,144,27303,7102,7772,12514,3689,3512,95735,84817,20722,31640,-41540,0,0,0,23432,0,0,0,20201,0,0,0,-4742,0,0,0,500.75,0,0,0
WHEAT - KANSAS CITY BOARD OF TRADE,1/16/2007,001612,113454,18708,59197,25319,1951,144,25523,7286,7676,12819,3397,3483,93672,83134,19782,30320,-40489,0,0,0,23368,0,0,0,18237,0,0,0,-5143,0,0,0,492,0,0,0
WHEAT - KANSAS CITY BOARD OF TRADE,1/9/2007,001612,116398,20004,59562,27102,1923,144,23393,7979,7753,12996,3518,3350,94742,84229,21656,32169,-39558,0,0,0,25179,0,0,0,15414,0,0,0,-5243,0,0,0,471.5,0,0,0
WHEAT - KANSAS CITY BOARD OF TRADE,1/3/2007,001612,119900,17295,63286,28123,1280,194,25361,6796,7949,12844,3365,2966,94732,85836,25168,34064,-45991,0,0,0,26843,0,0,0,18565,0,0,0,-4895,0,0,0,486.75,0,0,0
WHEAT - KANSAS CITY BOARD OF TRADE,12/26/2006,001612,115899,15753,64978,28822,1128,238,24006,5069,8166,14268,3300,3033,94286,85912,21613,29987,-49225,0,0,0,27694,0,0,0,18937,0,0,0,-6102,0,0,0,520,0,0,0
WHEAT - KANSAS CITY BOARD OF TRADE,12/19/2006,001612,114657,15191,65893,29466,663,268,23327,5144,8395,13172,1805,3097,92916,85265,21741,29392,-50702,0,0,0,28803,0,0,0,18183,0,0,0,-4777,0,0,0,502,0,0,0
WHEAT - KANSAS CITY BOARD OF TRADE,12/12/2006,001612,115611,14285,67259,29680,0,294,24968,4405,9030,13435,1690,3495,95187,86173,20424,29438,-52974,0,0,0,29680,0,0,0,20563,0,0,0,-4405,0,0,0,495.75,0,0,0
WHEAT - KANSAS CITY BOARD OF TRADE,12/5/2006,001612,121976,14306,74970,30141,0,242,27817,3976,8174,15536,2083,2741,98957,92186,23019,29790,-60664,0,0,0,30141,0,0,0,23841,0,0,0,-7362,0,0,0,518,0,0,0
WHEAT - KANSAS CITY BOARD OF TRADE,11/28/2006,001612,118820,13792,71873,29780,0,260,28864,3944,8431,13515,1615,2972,97614,89095,21206,29725,-58081,0,0,0,29780,0,0,0,24920,0,0,0,-5084,0,0,0,518.5,0,0,0
WHEAT - KANSAS CITY BOARD OF TRADE,11/21/2006,001612,124613,12653,72349,29651,0,235,25563,3885,12495,17350,2058,4073,102020,95095,22593,29518,-59696,0,0,0,29651,0,0,0,21678,0,0,0,-4855,0,0,0,514.75,0,0,0
WHEAT - KANSAS CITY BOARD OF TRADE,11/14/2006,001612,125557,14597,70611,30207,0,178,25727,4230,12352,14074,2632,4248,101383,94251,24174,31306,-56014,0,0,0,30207,0,0,0,21497,0,0,0,-1722,0,0,0,518.75,0,0,0
WHEAT - KANSAS CITY BOARD OF TRADE,11/7/2006,001612,134287,17857,75957,30263,0,189,29709,4721,11250,15556,2906,5600,110424,100623,23863,33664,-58100,0,0,0,30263,0,0,0,24988,0,0,0,-4306,0,0,0,525.75,0,0,0
WHEAT - KANSAS CITY BOARD OF TRADE,10/31/2006,001612,133642,20865,76570,30064,0,229,30410,5168,10522,14079,2694,5254,111423,100437,22219,33205,-55705,0,0,0,30064,0,0,0,25242,0,0,0,-3557,0,0,0,516,0,0,0
WHEAT - KANSAS CITY BOARD OF TRADE,10/24/2006,001612,134142,21095,77259,29025,0,229,30675,6033,11339,15432,2479,5278,113073,102617,21069,31525,-56164,0,0,0,29025,0,0,0,24642,0,0,0,-4093,0,0,0,545.25,0,0,0
WHEAT - KANSAS CITY BOARD OF TRADE,10/17/2006,001612,136056,21712,74765,27154,0,294,30288,7716,11336,15059,1961,4694,110537,100766,25519,35290,-53053,0,0,0,27154,0,0,0,22572,0,0,0,-3723,0,0,0,530.5,0,0,0
WHEAT - KANSAS CITY BOARD OF TRADE,10/10/2006,001612,150636,20096,79071,26560,0,539,34908,7762,15094,14897,1881,8533,120627,112880,30009,37756,-58975,0,0,0,26560,0,0,0,27146,0,0,0,197,0,0,0,513.25,0,0,0
WHEAT - KANSAS CITY BOARD OF TRADE,10/3/2006,001612,156584,21344,83921,25391,0,181,37195,8115,17711,15449,1822,10081,127352,121831,29232,34753,-62577,0,0,0,25391,0,0,0,29080,0,0,0,2262,0,0,0,491.75,0,0,0
WHEAT - KANSAS CITY BOARD OF TRADE,9/26/2006,001612,153791,23658,84169,23655,0,175,34924,8492,16298,17162,2025,10029,125901,121188,27890,32603,-60511,0,0,0,23655,0,0,0,26432,0,0,0,-864,0,0,0,479.5,0,0,0
WHEAT - KANSAS CITY BOARD OF TRADE,9/19/2006,001612,156609,25361,87473,23837,0,25,35565,7323,19157,16035,1784,8216,128196,123978,28413,32631,-62112,0,0,0,23837,0,0,0,28242,0,0,0,3122,0,0,0,480.75,0,0,0
WHEAT - KANSAS CITY BOARD OF TRADE,9/12/2006,001612,157920,27532,87822,23622,0,25,35652,8335,18858,14710,2141,7483,127882,124664,30038,33256,-60290,0,0,0,23622,0,0,0,27317,0,0,0,4148,0,0,0,456,0,0,0
WHEAT - KANSAS CITY BOARD OF TRADE,9/5/2006,001612,161110,29194,89900,22708,179,25,35148,8527,19411,16357,2267,7064,129907,127373,31203,33737,-60706,0,0,0,22529,0,0,0,26621,0,0,0,3054,0,0,0,468,0,0,0
WHEAT - KANSAS CITY BOARD OF TRADE,8/29/2006,001612,159767,28637,90796,21338,221,0,34073,7881,18919,19094,1792,6523,128584,126132,31183,33635,-62159,0,0,0,21117,0,0,0,26192,0,0,0,-175,0,0,0,460.25,0,0,0
WHEAT - KANSAS CITY BOARD OF TRADE,8/22/2006,001612,165198,26124,90193,21235,0,0,34830,8545,20376,19833,2836,6704,129102,128654,36096,36544,-64069,0,0,0,21235,0,0,0,26285,0,0,0,543,0,0,0,446.5,0,0,0
WHEAT - KANSAS CITY BOARD OF TRADE,8/15/2006,001612,160419,26229,91090,21478,0,229,35247,7871,15581,20391,3156,5913,125068,123840,35351,36579,-64861,0,0,0,21478,0,0,0,27376,0,0,0,-4810,0,0,0,449.75,0,0,0
WHEAT - KANSAS CITY BOARD OF TRADE,8/8/2006,001612,168763,26660,101350,21500,0,0,38085,5940,11300,21418,2822,7380,126343,128792,42420,39971,-74690,0,0,0,21500,0,0,0,32145,0,0,0,-10118,0,0,0,469.75,0,0,0
WHEAT - KANSAS CITY BOARD OF TRADE,8/1/2006,001612,170722,26390,105491,22110,0,0,39980,7177,10197,25606,2900,8308,132591,134073,38131,36649,-79101,0,0,0,22110,0,0,0,32803,0,0,0,-15409,0,0,0,482,0,0,0
WHEAT - KANSAS CITY BOARD OF TRADE,7/25/2006,001612,167640,28893,109631,21884,0,4,41492,6826,8022,25742,2582,7959,133996,135024,33644,32616,-80738,0,0,0,21884,0,0,0,34666,0,0,0,-17720,0,0,0,489.5,0,0,0
WHEAT - KANSAS CITY BOARD OF TRADE,7/18/2006,001612,167825,28947,111995,21837,0,2,42434,6333,5882,26163,2241,8275,133540,134728,34285,33097,-83048,0,0,0,21837,0,0,0,36101,0,0,0,-20281,0,0,0,490.25,0,0,0
WHEAT - KANSAS CITY BOARD OF TRADE,7/11/2006,001612,170592,25862,117972,21970,0,2,49738,4442,7201,27341,2140,6985,139099,138742,31493,31850,-92110,0,0,0,21970,0,0,0,45296,0,0,0,-20140,0,0,0,517,0,0,0
WHEAT - KANSAS CITY BOARD OF TRADE,7/3/2006,001612,163121,23396,110810,21494,0,2,43862,2728,8019,26573,3372,6747,130093,131678,33028,31443,-87414,0,0,0,21494,0,0,0,41134,0,0,0,-18554,0,0,0,503,0,0,0
WHEAT - KANSAS CITY BOARD OF TRADE,6/27/2006,001612,158177,25863,105813,20909,0,45,40161,2735,7599,24831,3035,6208,125616,125435,32561,32742,-79950,0,0,0,20909,0,0,0,37426,0,0,0,-17232,0,0,0,493.5,0,0,0
WHEAT - KANSAS CITY BOARD OF TRADE,6/20/2006,001612,149773,25482,97852,22377,0,100,34588,3379,7339,23204,3216,5593,118683,117479,31090,32294,-72370,0,0,0,22377,0,0,0,31209,0,0,0,-15865,0,0,0,473,0,0,0
WHEAT - KANSAS CITY BOARD OF TRADE,6/13/2006,001612,148726,20377,94027,22667,0,222,36633,3412,5235,22139,2914,6437,113710,112247,35016,36479,-73650,0,0,0,22667,0,0,0,33221,0,0,0,-16904,0,0,0,471.5,0,0,0
